√haʰ	root	many
√haʰ	root	willing
√haʰ	root	wrestle
√ha	root	move invisibly
ḵutx̱.ayanahá	noun	star (< √ha ‘move invisibly’)
ÿax̱ḵuhá	noun	season (< √ha ‘move invisibly’)
ÿahaaÿí	noun	shadow, soul (< √ha ‘move invisibly’)
ÿakwg̱ahéiÿag̱u	noun	spirit (< √ha ‘move invisibly’)
√ha	root	move mass, dig, gather
√ha	root	become located
√ha	root	(un)obvious (neg. only)
háʼ	interj	surprise
haaⁿ	dirn	here, hither
shkʼaandé	interj	gimme (< shkʼé haaⁿ-dé)
haa	pron	our, us, first person plural possessor or object
haa	interj	well then (< haaw)
ha.é	interj	sheesh, oh you (<? wa.é)
haahá	interj	annoyance
haahée	interj	gimme (< haaⁿ)
tuháaÿi	noun	nail (<? tú ‘inside’ + √ha ‘become located’)
haaw	noun	hemlock branch
haaw	interj	well then (< *haam)
hawháw	interj	astonishment
kuhaawú	noun	beaver tail
√han	root	sg. stand
√han	root	adopt, raise
√han	root	cut into strips
kahánti	noun	strips (< √han ‘cut into strips’)
kuhaantí	noun	orphan
-háan	affix	plural pronoun suffix
ḵuháan	noun	dwellers (> ḵwáan)
háanís	noun	harness (< Eng.)
hándít	noun	hundred (< CJ hándlət or Eng. hundred)
√hat	root	carry heavy object
koohádaa	noun	heavy thing carrier (< √hat ‘carry heavy object’)
√hat	root	cover
háat	noun	cover (< √hat ‘cover’)
√hat	root	feel around (esp. for lice?)
haat	noun	current, strong tide
shkahaadí	interj	crazy
√hátk	root	tremble due to nerve damage
√hátkw	root	fast (> √sátkw ‘fast’)
√haʼt	root	herd
háatlʼ	noun	crap (< √hatlʼ ‘crap’; cf. √hasʼ ‘vomit’, háachʼ ‘shame’)
√hatlʼ	noun	crap (cf. √hasʼ ‘vomit’, háachʼ ‘shame’)
hás	pron	third person human plural
háasʼ	noun	vomit (< √hasʼ ‘vomit’; cf. √hatlʼ ‘crap’, háachʼ ‘shame’)
√hasʼ	root	vomit (cf. √hatlʼ ‘crap’, háachʼ ‘shame’)
√hash	root	float
√hach	root	tingle, itch
√háachʼi	root	shameful (< háachʼ ‘shame’)
háachʼ	noun	shame (cf. √hasʼ ‘vomit’, √hatlʼ ‘crap’)
√hakw	root	suspect
√hakw	root	encourage
kaháakw	noun	fish eggs
√haakʼú	root	pretend
hé	det	this, mesioproximal
héi	interj	delight, surprise
heʼ	interj	yeah
x̱aaheiwú	noun	gooseberry
naahéin	noun	gambling game
√héin	root	claim
√héinaa	root	pump for information
yilaheil	interj	shaman fish killing
héil	pcl	negative
hél	pcl	negative
√hélʼk	root	weak
héitlʼ	interj	huge
√hesh	root	disgrace
kaheish	noun	disgrace (< √hesh ‘disgrace’)
héix̱waa	noun	charm (cf. √hixw ‘bewitch’)
√heʼk	root	move hyperactively
√heʼk	root	grumble, complain (rare, perh. <? √heʼk ‘move hyperactively’)
√hiʰ	root	pay shaman
heexʼ	noun	payment to shaman (< √hiʰ ‘pay shaman’ + -xʼ ‘plural’)
√hée	root	evil
ahée	interj	I wish!
heeyáa	interj	impatience
ḵukahín	noun	cranky in ḵukahínt uwanúk ‘he got cranky’
-dahéen	affix	times in numerals, e.g. twice, three times
√hin	root	pl. fish swim
√hin	root	believe
√héen	root	mix with water
héen	noun	fresh water; river
tleḵwkahínti	noun	watermelon berries (< tléiḵw ‘berry’ + héen ‘water’)
héengé	interj	you see? (< iyatéen gé ‘do you see?’)
hít	noun	house, building
√hits	root	singe fur
√hisʼ	root	borrow
√hich	root	spy on
√hixw	root	bewitch
héexu	noun	witchcraft
√hik	root	full of solid mass
√hik	root	scamper, frisk (cf. √heʼk ‘move hyperactively’)
aandaatkanahígi	noun	monkey	(< aan ‘town’ + daat ‘around’ + kanahík ‘frisk’)
√hu	root	wade, swim on surface
√hu	root	suspect
hú	pron	third person human (cf. du, u-)
huhuhu	interj	pain
hohoho	interj	pain
anahoo	noun	rutabaga (<? CJ)
ÿanahoo	noun	rutabaga (<? CJ)
hóo	interj	comprehension
ahó	interj	comprehension
ahóo	interj	comprehension
√hun	root	sell
hóon	noun	sale (< √hun ‘sell’)
húnx̱w	noun	male’s older brother
√hut	root	carry in apron
√hut	root	outrig canoe
√hul	root	nod off to sleep
√hutlʼ	root	wrinkle
hóochʼ	noun	finished, used up
√huk	root	give shout
hóhó	interj	emphasis with gunalchéesh ‘thank you’
yeihó	interj	unknown exclamation, canoeing?, hauling?
√.a	root	end move; grow; examine (cf. √.éiyáḵw ‘incapacitated’)
√.a	root	sg. sit
éinaa	noun	drying rack (< √.a ‘sg. sit’)
√.a	root	delay
á	pron	it, third person nonhuman
a-	pron	third person nonhuman object; fourth person human subject (mot.)
a	pron	its, third person nonhuman possessor
-aa	affix	instrumental nominalization (cf. -áa, aa ‘partitive’)
-áa	affix	instrumental nominalization (cf. -aa, aa ‘partitive’)
aa	pron	some/one of, partitive (cf. -áa, -aa, aa ‘who’, aadóo ‘who’)
aa	pron	indefinite who in wh-question (cf. aa ‘partitive’, aadóo ‘who’)
aa	interj	um, well, hesitation
aaa	interj	um, well, hesitation
keewa.áa	noun	up in air
daḵla.á	noun	jackpine
aadóo	pron	definite who in wh-question (< aa ‘who’ + dóo unknown)
gu.aa	pcl	hopefully
ḵu.aa	pcl	however
ḵu.a	pcl	however
ḵwa	pcl	however
áa	noun	lake
naasa.áa	noun	tool case
aaá	interj	yes (< aahá ‘yes’)
aahá	interj	indeed (> aaá ‘yes’)
dix̱ʼkana.áaÿi	noun	moose’s hump (< díx̱ʼ ‘spine’)
√.aʼw	root	strap (cf. ÿa.áawu, shuka.áwli)
ÿa.áawu	noun	strap (< √.aʼw ‘strap’)
shuka.áwli	noun	line holding end of something in place (< √.aʼw ‘strap’)
-án	affix	restore, go back to ordinary state, used with verbs
√.an	root	rinse in snow
√.an	root	rest
aan	noun	town, land
√.àan	root	settle, make town (< aan ‘town, land’)
lingitʼaaní	noun	world (< lingít ‘person’ + aan ‘town, land’)
ltʼaaní	noun	world (< lingitʼaaní ‘world’)
√.àan	root	kind
tula.aan	noun	kindness (< √.àan ‘kind’)
√.aʼn	root	bedridden
áan	noun	fish trap
áanjís	noun	orange (< CJ ólanjis < Eng. oranges)
ánkʼw	noun	spoiled brat
√.ánkʼw	root	spoiled (< ánkʼw ‘brat’)
át	noun	thing
át	pron	something, fourth person nonhuman (cf. át ‘thing’)
at	pron	its, fourth person nonhuman possessive (cf. át ‘thing’)
√.at	root	pl. go
kanas.aat	noun	crawling insect (<? √.at ‘pl. go’)
tooxée.aat	noun	hives
aat	noun	father’s sister
áadaa	noun	fish spear (occ. éidaa)
lu.áadaa	noun	marbled godwit? (<? áadaa ‘fish spear’)
ÿinaak.áatʼani	noun	lid, cover (cf. ÿanáa ‘covering’, √.a ‘end move’)
ÿana.áatʼani	noun	lid, cover
ÿana.áaktʼani	noun	lid, cover
ÿanáatʼi	noun	lid, cover
ÿaÿakʼáatʼi	noun	lid, cover
niÿa.áatʼani	noun	lid, cover
ÿanáatʼani	noun	lid, cover
√.atʼ	root	cold
áatʼ	noun	cold (< √.atʼ ‘cold’)
áatʼlani	noun	slime of shellfish (< √.atʼ ‘cold’)
áatʼl	noun	food storage pit (< √.atʼ ‘cold’)
áali	noun	grandparent, grandfather (occ. éili)
√.aʼl	noun	call as grandfather (<? áali ‘grandparent’)
√.as	root	lonesome
aas	noun	tree
aasgutú	noun	forest (< aas ‘tree’ + gú ‘base’ + tú ‘inside’)
asyádi	noun	sapling (< aas ‘tree’ + yát ‘child’)
√.àas	root	be(come) tree
asxʼaansháachʼi	noun	green bird
tu.áas	noun	kind of fish species like hooligan
√.atsʼ	root	insufficient (cf. √.átlʼ & √.achʼ ‘insufficient’)
√.atlʼ	root	insufficient (cf. √.átsʼ & √.achʼ ‘insufficient’)
√.achʼ	root	insufficient (cf. √.átsʼ & √.atlʼ ‘insufficient’)
√.aʼsh	root	sap run (cf. aas ‘tree’)
aashát	noun	steelhead
√.ak	root	weave (cf. √.aʼk ‘stagger’)
√.aʼk	root	stagger, stumble when wounded (cf. √.ak ‘weave’)
ya.áak	noun	space for, room
√.axʼw	root	crack
√.axʼw	root	bitter
áx̱	interj	frustration, disgust
ax̱	pron	my, first person singular possessor
√.ax̱	root	handle fabric (cf. √.ax̱w ‘bind’)
√.ax̱	root	hear (cf. √.ax̱ch ‘understand’)
√.ax̱ch	root	understand (< √.ax̱ ‘hear’)
√.ax̱w	root	tie up, bind (cf. √.ax̱ ‘handle fabric’)
ka.áax̱u	noun	binding (< √.ax̱w ‘tie up, bind’)
ḵʼalukas.aax̱w	noun	small trail snowshoes (< √.ax̱w ‘tie up, bind’)
at.sʼaan.áx̱w	noun	wrapping (< √.ax̱w ‘tie up, bind’)
√.aḵw	root	plan, order; try, attempt
-áḵ	affix	lacking, absent (cf. -áḵw ‘lacking, absent’)
-áḵw	affix	lacking, absent (cf. -áḵ ‘lacking, absent’)
-ḵ	affix	lacking, absent (cf. -áḵw ‘lacking, absent’)
éi	interj	hey
wa.é	pron	you, second person singular
ma.é	pron	you, second person singular
√.e	root	slide
√.e	root	shaman ask for more
éihu	interj	paddling call
√.éiyáḵw	root	incapacitated (< √.a ‘end move, grow’ + -áḵw ‘lacking’)
√.éin	root	starving
éin	noun	starvation (< √.éin ‘starving’)
-eit	affix	thing (< -i + át ‘thing’; cf. -ÿeit, -weit, -neit, -deit, -jeit)
yaana.eit	noun	indian celery
éili	noun	grandparent (< áali ‘grandparent’)
√.elʼ	root	salt
éilʼ	noun	salt, saltwater (< √.elʼ ‘salt’)
√.es	root	stagger
éitskʼ	interj	yum
√.etsʼ	root	careful
√.ék	root	frail
√.eʼk	root	paralyzed by shock
√.éikw	root	whistle
akoo.éikw	noun	whistle (< √.éikw ‘whistle’)
éix̱ʼ	noun	slough
-i	affix	relative clause, suffix on relativized verbs (cf. -í)
-í	affix	subordinate clause, suffix on subordinated verbs (cf. -i, -í)
-í	affix	nominalization, suffix on nominalized verbs (cf. -i, -í)
-í	affix	possessive, suffix on possessed nouns (cf. -ÿí, -wú, etc.)
i	pron	your, second person singular possessor or object
ee	pron	your, second person singular possessor or object
√.i	root	cook
éewu	adj	cooked (< √.i ‘cook’)
at.éewu	noun	cooking (< át ‘thing’ + éewu ‘cooked’)
atʼiweit	noun	cooking pot (< √.i ‘cook’; cf. -weit)
√.i	root	landslide
daagoo.ée	noun	landslide (< daak ‘down’ + √.i ‘landslide’)
ee	affix	pronominal base for postpositions (cf. eetí, ít)
een	ppn	with, instrumental postposition (< ee + -n)
ée	interj	disgust
éeee	interj	disgust
éekʼ	noun	female’s brother
eeÿ	noun	rapids
ín	noun	flint
√.in	root	gather; filled container
√.éen	root	guard
√.in	root	kill pl.
éenaa	noun	tongs
éenyee	noun	armpit
éenee	noun	armpit
ít	noun	after, following
eetí	noun	room, place of, remains of (< eet + -í, cf. ee, ít)
ḵaankak.eetxʼ	noun	in public
√.éet	root	not fit, change proportion
éet	noun	halibut hole
éedaa	noun	water phosphorescence
√.itʼ	root	soak
ítʼch	noun	glass (< √.ítʼch ‘sparkle’)
√.ítʼch	root	sparkle
√.ées	root	whistle breathily
eest	noun	yeast (< Eng.)
ísh	noun	fish hole in river
√.ish	root	string objects
eesháan	noun	poor, pitiful
éesh	noun	father
eech	noun	rock, reef
éechʼ	noun	boulder, round stone
éex	dirn	downriver, south
√.ixʼ	root	call, shout
eex̱	noun	oil
íx̱tʼ	noun	shaman
eeḵ	noun	copper
éeḵ	noun	beach
eeḵ	noun	top of foot in iḵká ‘top of foot’
éex̱ʼ	noun	slough
ó	interj	oh, understanding
-ú	affix	at, locative predicate suffix
√.uʰ	root	put, leave
√.uʰ	root	own, buy
óowu	noun	property (< √.uʰ ‘own, buy’)
duwuweit	noun	wealth, possessions (< √.uʰ ‘own, buy’; cf. -weit)
duweiyí		noun	freedom of slave (in duweiyít wududli.óo < √.uʰ)
at.óow	noun	clan property (< √.uʰ ‘own, buy’)
u-	pron	third person human
u-	affix	irrealis
óo	interj	pain, dislike
úyʼ	interj	sudden, unsettling
√.uʼn	root	shoot with gun
óonaa	noun	gun (< √.uʼn ‘shoot with gun’)
óon	noun	whitefish
Ana.óot	name	Aleut people, Alutiiq people
√.uʼt	root	remove splinter
√.utʼ	root	adhere by suction
óotʼ	noun	sucker (< √.utʼ ‘adhere by suction’)
yaka.óotʼ	noun	button (< √.utʼ ‘adhere by suction’)
óotʼ	noun	rock trap
√.utl	root	boil fish
útlx̱i	noun	boiled fish (< √.utl ‘boil fish’)
√.us	root	sulk, pout (cf. √.ush ‘sulk’)
√.us	root	playful
óoskʼ	interj	cute! (cf. úxkʼ ‘how tiny!’)
√.usʼ	root	wash
óosʼi	noun	laundry (< √.usʼ ‘wash’)
úsʼaa	noun	soap (< √.usʼ ‘wash’)
√.ush	root	sulk (cf. √.us ‘sulk, pout’)
óosh	pcl	hypothetical
úxkʼ	interj	how tiny! (cf. óoskʼ ‘cute!’)
√.uʼx	root	blow
óox	noun	gas (in óoxh shawlihík ‘he’s filled with gas’, < √.uʼx ‘blow’)
óoxjaa	noun	wind (< √.uʼx ‘blow’)
tooxsʼeit	noun	bugle, pipe (< √.uʼx ‘blow’)
√.uk	root	pl. slide; boil
√.uk	root	frost up
óoxʼ	noun	shoulderblade
√.ukʼ	root	play with things (< √.uʰ ‘own, buy’ + -kʼ ‘diminutive’)
oox̱	noun	tooth
√ya	root	pack, carry on back
yáanadi	noun	thing packed (< √ya ‘pack’)
yá	det	this, proximal
yáakʼu	adv	right away with chʼa
yaa	noun	sea trout
heeyáa	interj	impatience
ayaheeyáa	noun	curlew
dagwitgiyáa	noun	hummingbird
dagitgiyáa	noun	hummingbird
digitgiyáa	noun	hummingbird
dagwatgiyáa	noun	hummingbird
neistʼiyáa	noun	red currant (cf. neeltʼiyáa)
neeltʼiyáa	noun	red currant (cf. neistʼiyáa)
sʼawangasayáa	noun	red beetle (cf. sʼawgusayáa)
sʼawgusayáa	noun	red beetle (cf. sʼawangasayáa)
dendewooyáa	noun	kind of thong (< Dene lgs.)
√yàa	root	weird, strange
√yaaÿí	root	submerged
yáaÿ	noun	whale
yaaw	noun	herring
héiyáaw	interj	fish are jumping
Ayáan	name	Yukon Dene people (N. Tutchone, Hän, Gwichʼin, etc.)
nukshiyáan	noun	mink (cf. lukshiyáan)
lukshiyáan	noun	mink (cf. nukshiyáan)
kiksyáan	noun	baby killerwhale
ínyán	noun	onion (< Eng.)
√yat	root	pleat
kichyaat	noun	tern
shaayáal	noun	hawk
tayáadzi	noun	honeycomb ice
tʼíxʼyáadzi	noun	honeycomb ice
chʼiyáash	noun	small canoe
Daasʼadiyáash	name	Dezeadeash Lake (also Dáasʼaadiyéshḵ, Dáasʼaakayáash)
yáxwchʼ	noun	sea otter
dziyáak	adv	earlier, previously; later
yaakw	noun	canoe, boat
Lḵʼayáakʼw	name	man whose footprints (x̱ʼus.eetí) are the Milky Way
yáx̱	ppn	like
yaax̱	noun	bank, side edge
Giyáḵw	name	Sugpiaq people, Alutiiq people (< Eyak)
yéi	adv	thus, so (cf. yóo ‘thus’)
koonaayei	noun	chipmunk
atskʼiyé	noun	kind of duck species
√yeʼn	root	twirl, wave, wag
yéin	noun	sea cucumber
√yel	root	lie, deceive (cf. yéil ‘raven’)
yéil	noun	raven (< *yaˀyaɬ; cf. √yel ‘lie, deceive’)
√yelʼ	root	calm, peaceful
kayéilʼ	noun	peace
yéilʼ	noun	elderberry
yeis	noun	horseshoe clam
ÿees	noun	horseshoe clam
yeis	noun	autumn
√yesʼ	root	blacken, discolour (cf. ÿéisʼ ‘obsidian’)
daakayésʼaa	noun	shoe polish (< √yesʼ ‘blacken, discolour’)
yétsʼ	noun	jet black (cf. √yesʼ ‘blacken, discolour’)
ÿéisʼ	noun	dark; obsidian; bruise (< √yesʼ ‘blacken, discolour’)
kayéisʼ	noun	dye (< √yesʼ ‘blacken, discolour’)
daaÿéisʼ	noun	black furred weasel (< dáa ‘weasel’ + yéisʼ ‘dark’)
iḵÿéisʼ	noun	iron (< eeḵ ‘copper’ + yéisʼ ‘dark’)
g̱aÿéisʼ	noun	iron (< iḵyéisʼ ‘iron’)
kooyéix	noun	camprobber
√yek	root	roomy
√yek	root	animated, alert; too fast
yéik	noun	shaman’s spirit
kayéik	noun	sound of machine (< √yek ‘animated, alert’)
ḵuyéik	noun	spirit of animal (< yéik ‘shaman’s spirit’)
√yéik	root	be(come) inhabited by spirits (< yéik ‘shaman’s spirit’)
√yeʼk	root	stagger
√yex̱	root	make, build
yéix̱	noun	deadfall (< √yex̱ ‘make, build’)
√yex̱	root	shave, plane
kayéx̱aa	noun	wood plane
yayéx̱aa	noun	razor
kayeix̱tág̱u	noun	shavings
√yex̱	root	absent (with irrealis u-)
yéesʼ	noun	large mussel
yayík	noun	sound of animal (cf. yéik ‘shaman’s spirit’)
kayík	noun	extrasensory perception (cf. yéik ‘shaman’s spirit’)
√yu	root	adopt
yoow	noun	stomach
yóo	adv	thus, so, quotation (cf. yéi ‘thus’)
tsʼayóokʼ	adv	immediately, suddenly, right away (cf. yóo ‘thus’)
yú	det	that, distal
yóotg̱aanyís	adv	just in case (cf. yú ‘that’, ÿís ‘for’)
yóotg̱aantsá	adv	in some remote future (cf. yóotg̱aanyís ‘just in case’)
yóoxgaa	noun	skirt (< Ru. юпка)
√yuʼk	root	shake
√yux̱ʼ	root	soaked, waterlogged
√yux̱ʼ	root	gnaw, eat with teeth
yooḵ	noun	cormorant
√ÿaʰ	root	move uncertainly; happen, occur
√ÿaʰ	root	resemble (with irrealis u-)
kaÿaa	noun	duplicate
uwáa	adj	resembling, ersatz
√ÿa	root	lower
shaÿéinaa	noun	anchor
ÿaÿéinaa	noun	whetstone
ÿá	noun	face, vertical surface
ÿáag̱aa	ppn	through (time)
ig̱aÿáak	noun	beach below town
g̱unaÿáa	adv	different
g̱uwanáa	adv	different (< g̱unaÿáa)
diÿáa	dirn	across, through
niÿaa	noun	direction of; blocking, covering (< *niŋaʰ)
ÿinaa	noun	direction of; blocking, covering (metathesis of niÿaa)
wanÿaadé	noun	different
tʼeinÿaa	noun	lining
doonÿaa	noun	under clothes (< dook ‘skin’ + niÿaa)
shanÿaa	noun	low tide (<? shá ‘head’ or shú ‘end’ + niÿaa)
yuwaa	noun	alternating between (< yuÿaa <?)
tliÿáa	noun	further over
ÿáanáx̱	ppn	more than
ÿán	noun	shore
ÿán	noun	western hemlock
=ÿán	affix	plural junior kinship
ÿaan	noun	hunger
kaÿaaní	noun	leaves
kʼuwaaní	noun	deer cabbage (<? kaÿaaní)
ÿát	noun	child
√ÿát	root	play
ÿaat	noun	fathom (cf. waat)
kichÿaat	noun	tern (< kích + ÿaat)
√ÿatʼ	root	long (cf. √ÿatlʼ ‘short’, √ÿachʼ ‘too short’)
√ÿatlʼ	root	short (cf. √ÿachʼ ‘too short’, √ÿatʼ ‘long’)
√ÿachʼ	root	too short (cf. √ÿatlʼ ‘short’, √ÿatʼ ‘long’)
ÿáts	noun	child (in =kʼiÿátskʼu ‘small’, see =kʼátskʼu)
=kʼiÿátskʼu	affix	small (< kʼi + ÿáts ‘child’ + -kʼ ‘dimin.’)
=kʼátskʼu	affix	small (< kʼiÿátskʼu)
√ÿasʼ	root	smooth
√ÿasʼ	root	move foot
ÿáash	noun	shelf in a smokehouse
kaÿáash	noun	platform
√ÿáash	root	build platform (< ÿáash)
√ÿáshḵ	root	scarce, lacking (< *√ÿash + -ḵ ‘lacking’)
ÿaak	noun	mussel
lḵukanÿáaxʼ	adv	for nothing, for no purpose
√ÿáakw	root	deny
√ÿaḵw	root	liken, make simile; bequeath
√ÿaax̱áḵw	root	make plan (< √ÿaḵw + -x̱? + -áḵw ‘lacking’)
ÿaax̱	noun	edge? (in tʼáaÿaax̱ ‘board for table’, héen x̱ʼaÿaax̱ ‘shoreline’)
ÿé	noun	place, way, manner, circumstance, time (cf. yéi ‘thus’)
√ÿéi	root	strange, weird (cf. √yàa ‘strange’)
ÿeit	noun	thing below (< ÿee + át)
-ÿeit	affix	thing (< –ÿi + át; cf. -weit, -neit, -deit, -teit, -jeit)
ÿeiḵ	noun	beach (< éeḵ ‘beach’)
-ÿí	affix	possessive, suffix on possessed nouns (cf. -í)
ÿee	noun	below
yei	adv	downward (cf. ÿee ‘below’)
shuwee	noun	lower end, edge (< shú + ÿee)
shiyee	noun	lower end, edge (< shú + ÿee)
wanÿee	noun	secret (< wán + ÿee)
wanee	noun	secret (< wanÿee)
diÿín	dirn	downward, below (cf. daÿee, ÿee)
daÿee	noun	below (cf. diÿín)
taÿee	noun	below, beneath (< tá + ÿee)
ÿee	noun	time (obsolete, only found in compounds, < *ŋiʰ)
yagiÿee	noun	day (cf. ÿee ‘time’, <? yáaxʼ ‘here’ + ÿee)
yakyee	noun	day (< yagiÿee)
yagee	noun	day (< yagiÿee)
ÿeedát	noun	now (< ÿee ‘time’ + dát unknown, cf. taat ‘night’)
ÿéeÿi	noun	former, previous (< ÿee ‘time’)
ÿeen	noun	time interval, during, middle (< ÿee ‘time’, -n ‘instr.’)
ÿinká	noun	middle of island (cf. ÿeen ‘time interval’)
√ÿiʼÿ	root	bind long obj.
shaÿéen	noun	nail (<? √ÿiʼÿ ‘bind long obj.’; Haida sangíin)
√ÿit	root	oily
√ÿiʼt	root	stretch
ÿéet	noun	son
ÿís	ppn	for, benefactive
x̱ʼéis	adv	for eating (< x̱ʼé + ÿís)
jís	adv	for having (< jee + ÿís)
niÿís	adv	for the time of (< ni- + ÿís)
leiÿís	noun	fir
ÿees	noun	wedge (cf. ÿéesʼ)
ÿéesʼ	noun	wedge (cf. ÿees)
ÿées	adj	new
√ÿish	root	pull (cf. √ÿiḵ ‘pull’)
ÿéesh	noun	leech, bloodsucker
√ÿich	root	pl. fly
x̱ʼalʼdaaÿéejayi	noun	plover (cf. xʼatʼdaaÿéejayi)
xʼatʼdaaÿéejayi	noun	plover (cf. x̱ʼalʼdaaÿéejayi)
ÿík	noun	inside concavity
kaawaÿík	noun	nowhere, thin air
√ÿiḵ	root	pull, draw (cf. √ÿish ‘pull’; > √ÿeḵ)
√ÿeḵ	root	pull, draw (< √ÿiḵ ‘pull’)
kaÿíg̱aa	noun	hoisting line (< √ÿiḵ ‘pull’)
shanaax̱kaÿéeḵ	noun	scarf (< √ÿiḵ ‘pull’)
√ÿiḵ	root	carry in mouth, bite
ÿéeḵ	noun	foremost or sternmost place in canoe (cf. √ÿiḵ ‘pull’; > ÿéiḵ)
ÿéiḵ	noun	foremost or sternmost place in canoe (< ÿéeḵ)
saÿeeḵ	noun	next day (cf. seig̱án ‘tomorrow’, ÿee ‘time’)
wáa	pron	how (wh-question)
wánwaa	noun	sailor (< Eng. man-o-war or CJ manawaa)
Wanwaasháa	name	woman of Kaagwaantaan clan (< wánwaa + sháa ‘woman’)
x̱ʼeisʼawáa	noun	ptarmigan; pigeon
wán	noun	edge
woon	noun	maggot (cf. √wan)
√wan	root	maggoty (cf. woon)
Kinjuchwaan	name	Canadian, English (< CJ kínjochman < Eng. King George)
ganaswáan	noun	worker (< CJ or Eng. businessman)	
sgóonwaan	noun	student (< CJ sgúlman < Eng. school + man)
Jáawaan	name	German (< CJ jáman or Eng. German)
Cháanwaan	name	Chinese (< CJ chánəman < Eng. chinaman)
Jaagwaanée	name	Japanese (< CJ japaní < Eng. Japanese)
Waaktwáani	name	Victoria (< CJ biktóli < Eng. Victoria)
waat	noun	fathom (cf. ÿaat)
√wat	root	measure fathom (cf. waat, ÿaat)
√wat	root	grow up, mature (cf. ÿát ‘child’, waat ‘fathom’)
wáat	noun	adult (in ÿées wáat ‘young adult’, ÿanwáat ‘adult’)
kawáat	noun	tumour
shaawát	noun	girl, woman (< sháa ‘woman’ + ÿát ‘child’)
wát	noun	mouth of river, delta
wáadishgaa	noun	priest (< Ru. батюшка)
√wal	root	have hole (cf. wool)
√walʼ	root	break, fracture (cf. √wutʼ ‘split along grain’, √wulʼ ‘peel’)
x̱ʼasʼkalawálʼ	noun	jawbreaker (< x̱ʼasʼ ‘jaw’ + ká + l- + √walʼ ‘break’)
√was	root	dry roast
wáasadi	noun	dry roasted fish
Kíswás	noun	Christmas (< CJ kísmas < Eng. Christmas)
wáasdla	noun	butter (< Ru. масло)
wásʼ	noun	bush; stem
√wusʼ	root	ask (cf. √wasʼ ‘ask’)
√wasʼ	root	ask (cf. √wusʼ ‘ask’)
wásh	noun	mush, oatmeal (< Eng.)
wásh	noun	cheek (cf. √wash ‘yawn’)
√wash	root	yawn (cf. wásh ‘cheek’)
sawáak	noun	large dog, bulldog (< Ru. собака)
jeeniwáḵ	noun	teakettle (< Sug. cainiiguaq < Ru. чайник)
waaḵ	noun	eye
x̱aawaag̱í	noun	window (< x̱aaÿ ‘steambath’ + waaḵ ‘eye’)
wé	det	there, that, mesiodistal
tawéi	noun	wild (Dall) sheep
wéinaa	noun	chalk (< √wu ‘pale’)
yawéinaa	noun	face powder (< √wu ‘pale’)
ÿéinaa	noun	white sand (< √wu ‘pale’)
Jiskʼuwéinayi	name	Alkali Flats above Warm Bay
-weit	affix	thing (< -wu + át; cf. -ÿeit, -neit, -deit, -teit, -jeit)
√weʼt	root	menstruate
wéitadi	noun	menstruant
Naawéiján	name	Norwegian (< Eng.)
wéisʼ	noun	louse; gland
wéiksh	noun	ulu
wéix̱ʼ	noun	bullhead
wínk	noun	milk (< Eng.)
√wu	root	send, take along
wóow	noun	lunch (< √wu ‘send, take along’)
√wu	root	float
√wu	root	dare (see √wuḵ)
√wu	root	pale (orig. ‘white’)
taanwú	noun	umbilical cord
lakʼéechʼwu	noun	surf scoter
wóo	noun	father-in-law
wóow	noun	chest, breast
woot	noun	red-cedar bark (cf. teeÿ woodí ‘yellow-cedar bark’)
kawóot	noun	bead
√wutʼ	root	split along grain (cf. √wulʼ ‘peel’, √walʼ ‘break’)
wool	noun	hole (cf. √wal ‘have hole’)
√wuʼtl	root	agitation, trouble
atḵaalawóodli	noun	intestinal worm of porcupine
√wulʼ	root	peel (cf. √wutʼ ‘split along grain’, √walʼ ‘break’)
√wutlʼ	root	stubborn (cf. √wuchʼ ‘stubborn’, √wusʼ ‘tough’)
waswóos	noun	cattle (< CJ musmús < Klamath; cf. wasóos)
√wusʼ	root	tough (cf. √wutlʼ ‘stubborn’, √wuchʼ ‘stubborn’)
√wusʼ	root	murky (cf. √wuchʼ ‘murky’)
√wuchʼ	root	murky (cf. √wusʼ ‘murky’)
√wuchʼ 	root	stubborn (cf. √wutlʼ ‘stubborn’, √wusʼ ‘tough’)
√wux̱	root	tide ebb, tide be small
lawúx̱	noun	young seagull, grey
√wuḵ	root	fabric fall
√wuḵ	root	pity, doubt
√wuḵ	root	scrape skin
wúg̱aa	noun	skin scraper
√wux̱ʼ	root	wide
√máamaa	root	call ‘mama’
máadushgaa	noun	priest’s wife (< Ru. матюшка)
√bélt	root	spell (< Eng. spelled)
-n	ppn	with, instrumental postposition (cf. een, teen)
-n	affix	stem variation suffix, causes ablaut of a→éi and u→wéi
√naʰ	root	damp; drink; rub with tallow
neisʼ	noun	tallow for rubbing (< √naʰ ‘damp; drink; rub with tallow’)
√na	root	inherit
néixʼi	noun	inheritance (< √na ‘inherit’ + -xʼ ‘pl.’)
néixʼt	noun	inheritance (< √na ‘inherit’ + -xʼ ‘pl.’ + -t ‘ictive’)
√na	root	carry bundles
g̱alnáatʼadi	noun	bundle (< √na ‘carry bundles’)
√naʷ	root	die
naawú	noun	corpse (< √naʷ ‘die’)
naná	noun	death (< √naʷ ‘die’)
dzaná	noun	sour smelling fish (in Raven story)
guḵx̱oodzanaayí	noun	dried salmon packed with góoḵ (in L73: 09/99; cf. dzaná)
ná	interj	here, take this
ḵunáa	adv	in chʼu ḵunáa ‘even though’ and yéi ḵunáa ‘about this time’
g̱una	adv	different
-naa	affix	area, direction (< niÿaa)
naa	dirn	upriver, against current, north (cf. nan-)
nan-	affix	upriver, against current, north (cf. naa)
naa	noun	tribe, clan
ÿinaa	noun	in the way of (< niÿaa)
√náaÿ	root	send, tell to go (cf. √náa)
√náa	root	send, tell to go (cf. √náaÿ)
atkunáaÿi	noun	commander (< √náaÿ)
náa	noun	covering, draped over; end of pointed object
ÿanáa	noun	covering (< ÿá + náa)
ÿináa	noun	covering (< ÿanáa)
ḵulkanáaxʼ	adv	in vain (cf. chʼawanáaxʼ, lḵukanyáaxʼ)
chʼakwanáaxʼ	adv	anyway (cf. ḵulkanáaxʼ, lḵukanyáaxʼ)
lukanáa	noun	dog eater demon (from southern tribes)
aganáa	interj	oh no, regret
weenáa	noun	sawmill (< CJ (lə)mulá < Fr. le moulin; not *woonáa)
naaw	noun	bilge water
náaw	noun	liquor (< CJ lam < Eng. rum)
Xoujunáay	name	Fourth of July (< Eng.)
Hinginan	name	England (< CJ or Eng.; also Inginan, Inginin)
√nal	root	steam; blow nose
náalx̱	noun	wealth; large halibut
√náalx̱	root	wealthy (< náalx̱ ‘wealth; large halibut’)
√natlʼ	root	prune, wrinkle and swell in water
lunás	noun	nose ring (< lú ‘nose’ + -nás unknown)
√nalʼ	root	throw in heap
taakw.aanási	noun	jellyfish (< táakw ‘winter’ + aaní ‘town’; cf. lunás)
naas	noun	intestines
Naas	name	Nass River
ganaasda	interj	hi (<? Eyak)
násʼk	num	three
√natsʼ	root	prune, wrinkle and swell in water (cf. √natlʼ)
nátsʼ	noun	worthless (cf. √nátsʼ); nátsʼ yáx̱ yatee ‘he’s good for nothing’
√naʼsh	root	shake; run in circles
gunáashísh	noun	molasses (< Eng.)
iḵnáachʼ	noun	brass (< eeḵ ‘copper’ + √nachʼ cf. √natsʼ, √natlʼ)
náxw	noun	halibut hook
√nak	root	become formed
kanágaa	noun	form for shaping (< √nak ‘become formed’)
danáak	noun	stone found in deer (< √nak ‘become formed’)
√naʼk	root	numb
náksʼ	noun	cold sore on tongue (<? √naʼk ‘numb’; cf. x̱aatlʼáḵw)
náakw	noun	medicine, drugs
√náakw	root	medicate (< náakw ‘medicine’)
kaḵéitsʼnáakw	noun	itch medicine
sx̱enx̱ináakw	noun	dog scratching medicine
ḵʼanáax̱án	noun	fence (< CJ qʼəláχan < Coast Salish)
-náx̱	ppn	through, along, perlative, prolative
-náx̱	affix	kind of bay in placenames (e.g. G̱aanáx̱, Sʼiknáx̱, Joonáx̱)
-náx̱	affix	human numeral, e.g. dáx̱náx̱ ‘two people’
náx̱ki	noun	needles accumulated under tree
√naḵ	root	pl. stand
shachkkanág̱u	noun	moss growing on muskeg (< √naḵ ‘pl. stand’)
náḵ	ppn	leaving behind, abessive, ablative (cf. √naḵ ‘leave behind’)
√naḵ	root	leave behind (cf. náḵ ‘leaving behind’)
√naḵw	root	rot and fall apart
naaḵw	noun 	rotten wood, punk (< √naḵw ‘rot and fall apart’)
náaḵw	noun	octopus
√naḵw	root	fish with octopus as bait (< náaḵw ‘octopus’)
√ne	root	work; knit; play with hands; direct, impel
né	noun	hair seaweed
yaa.aa.uné	noun	oldsquaw duck
tsʼanéi	noun	round split cedar basket (<? C.Tsim.)
dasdané	noun	suckerfish (cf. Kaska dasdanja)
ḵʼaakanéi	noun	deep dish for grease
néi	interj	hey, look
anixanéi	noun	bishop (< Ru. архиерей < Gk. ἀρχιερεύς)
tʼukanéiÿi	noun	baby (< tʼook ‘cradleboard’ + √neʼÿ ‘fiddle, twiddle’)
√neʼÿ	root	fiddle, twiddle
tsʼeig̱eenéi	noun	magpie (cf. tsʼeig̱eenée)
tsʼeig̱eenée	noun	magpie (cf. tsʼeig̱eenéi)
sakwnéin	noun	flour, bread (< CJ saplél < unknown)
-neit	affix	thing (< -ni + át; cf. -weit, -ÿeit, -deit, -teit, -jeit)
√net	root	tremble
nakwnéit	noun	priest, pastor (< CJ ləplét < Fr. le prêtre)
wuknéit	noun	priest (< nakwnéit)
néitʼ	noun	leech, bloodsucker (cf. ÿéesh ‘leech’)
neil	noun	home
gaanneilí	noun	smokehole covering (cf. gaanyéili)
√nelʼ	root	lug, carry bulky object against self (cf. √na ‘carry bundles’)
néilʼ	noun	cedar bark basket (<? √nelʼ ‘lug’)
kanéist	noun	cross (< Ru. крест)
√néist	root	in x̱akanéist ‘cross fox’, cf. x̱akaxwaan, x̱altʼoochʼ, x̱ax̱ʼaan
shanéitsaa	noun	Easter bread (< Ru. пшеница ‘wheat’; cf. Ru. кулич)
tlax̱aneisʼ	noun	kingfisher (< √naʰ ‘damp’, cf. neisʼ)
√neʼḵ	root	slushy
kaneiḵ	noun	melting snow, slush (< √neʼḵ ‘slushy’)
neig̱án	noun	rock wall fish trap (<? √neʼḵ ‘slushy’)
néx̱ʼw	noun	cloudberry (cf. náx̱ʼw)
náx̱ʼw	noun	cloudberry (cf. néx̱ʼw)
√niʰ	root	occur, happen, do; handle pl. obj.
√neʰ	root	occur, happen, do; handle pl. obj. (< √niʰ)
ni-	affix	in niÿís ‘for time of’, niÿaa ‘dirn’ (<? *ŋiʰ, cf. ÿeen ‘time’)
atsganée	interj	fright (cf. atsganéi)
atsganéi	interj	fright (cf. atsganée)
√niʼtl	root	human get fat (> √neʼtl)
√neʼtl	root	human get fat (< √niʼtl)
neetl	noun	human fatness (< √niʼtl)
neitl	noun	human fatness (< √neʼtl)
tlag̱anís	noun	pole, sapling (< tag̱anís)
tag̱anís	noun	pole, sapling (< taag̱án ‘poker’ + ÿís ‘for’)
nis-	affix	in nisdaat ‘last night’ (<? niÿís + taat ‘night’)
néesʼ	noun	sea urchin
√néesʼ	root	eat sea urchins (< néesʼ)
neech	noun	shoreline, beach
neechxʼ	adv	gratis, free, for nothing (< neech ‘shoreline’ + -xʼ ‘loc’)
nichká	noun	nowhere in particular (< neech ‘shoreline’ + ká ‘hsfc.’)
nichka.ádi	noun	useless thing (< nichká + át ‘thing’)
nichkáxʼ	adv	in vain, uselessly (< nichká + -xʼ ‘loc’)
√nix	root	poop, defecate (obscure)
√nik	root	tell, relate
neek	noun	news, gossip (< √nik ‘tell’)
nikshatléḵxʼu	noun	a gossip (< neek ‘news, gossip’ + shitléḵw ‘excessive’)
niksʼaatí	noun	a gossip (< neek ‘news, gossip’ + sʼaatí ‘master’)
gitguníksh	noun	kind of owl (cf. Eyak geˑłgəlid, Haida gutguníis)
√nikw	root	auxiliary verb root (< √nikw ‘feel’ or √nikw ‘act’)
neech	aux	habitual auxiliary (< √nikw ‘aux’ + -ch ‘habitual’)
nich	aux	habitual auxiliary (< √nikw ‘aux’ + -ch ‘habitual’)
nooch	aux	habitual auxiliary (< √nikw ‘aux’ + -ch ‘habitual’)
nuch	aux	habitual auxiliary (< √nikw ‘aux’ + -ch ‘habitual’)
nukch	aux	habitual auxiliary (< √nikw ‘aux’ + -ch ‘habitual’)
neejín	aux	past habitual auxiliary (< √nikw ‘aux’ + -ch ‘hab’ -ín ‘past’)
noojín	aux	past habitual auxiliary (< √nikw ‘aux’ + -ch ‘hab’ -ín ‘past’)
néekw	aux	consecutive habitual (< √nikw ‘aux’ + -Hμ ‘consecutive’)
nóok	aux	consecutive habitual (< √nikw ‘aux’ + -Hμ ‘consecutive’)
níkwni	aux	conditional habitual (< √nikw ‘aux’ + -ni ‘conditional’)
níkni	aux	conditional habitual (< √nikw ‘aux’ + -ni ‘conditional’)
núkni	aux	conditional habitual (< √nikw ‘aux’ + -ni ‘conditional’)
g̱aníkw	aux	contingent habitual (< √nikw ‘aux’ + g̱a-…-ín ‘contingent’)
g̱anígún	aux	contingent habitual (< √nikw ‘aux’ + g̱a-…-ín ‘contingent’)
g̱anúgún	aux	contingent habitual (< √nikw ‘aux’ + g̱a-…-ín ‘contingent’)
g̱anígín	aux	contingent habitual (< √nikw ‘aux’ + g̱a-…-ín ‘contingent’)
√nikw	root	feel; wind blow
néekw	noun	breeze (< √nikw ‘feel; wind blow’)
√nikw	root	act, with ḵu- (perh. same as √nikw ‘feel; wind blow’)
√neekw	root	lack confidence, doubt
√néekw	root	be annoyed, bothered (perh. same as √néekw ‘sick’)
√néekw	root	sick (< néekw ‘sickness’)
néekw	noun	sickness
néegwálʼ	noun	paint (<? néekw + -álʼ)
√néegwálʼ	root	paint (< néegwálʼ ‘paint’)
kanéegwálʼ	noun	jam; berries mixed with salmon eggs (< néegwálʼ ‘paint’)
x̱ʼanéegwálʼ	noun	lipstick (< x̱ʼé ‘mouth’ + néegwálʼ ‘paint’)
√nixʼ	root	smell
√nikʼ	root	fastidious, picky, neat, tidy
√nikʼw	root	pivot, swivel (> √nukʼ ‘pivot, swivel’)
√nukʼ	root	pivot, swivel (> √nikʼw ‘pivot, swivel’)
√nikʼw	root	pique interest (perh. same as √nikʼw ‘pivot, swivel’)
√nix̱	root	save, heal
g̱aneex̱í	noun	saviour (< √nix̱)
g̱aneex̱	noun	salvation (< √nix̱)
neex̱	noun	safe harbour (< √nix̱)
xunéikw	noun	bread of Eucharist (< Ru. хлеб; cf. ginóok)
√nex̱	root	save, heal (< √nix̱)
g̱aneix̱í	noun	saviour (< √nex̱)
g̱aneix̱	noun	salvation (< √nex̱)
tusg̱aneix̱	noun	pity (< √nex̱)
neix̱	noun	safe harbour (< √nex̱)
néex̱ʼ	noun	marble
néix̱ʼ	noun	marble (< √néex̱ʼ)
ḵux̱denóo	noun	eddy, whirlpool
noow	noun	flat island; fort; palisade fish trap
Xootsnoowú	name	Admiralty Island
hóotsʼanoo	noun	hooch, booze (< CJ húchənu < Tl. Xootsnoowú)
sʼiknóon	noun	glacier bear, wolverine (< sʼeek ‘bl. bear’, cf. x̱anóon)
x̱anóon	noun	brown bear (cf. sʼiknóon)
√nutʼ	root	swallow
nóotʼaÿi	noun	uvula (< √nutʼ ‘swallow’; cf. nóotʼani)
nóotʼani	noun	uvula (< √nutʼ ‘swallow’; cf. nóotʼaÿi)
ḵushnóotlʼ	noun	uncooperative
√nutlʼ	root	in ḵushnóotlʼ ‘uncooperative’
nóos	noun	news, gossip (< Eng. news; cf. neek ‘news, gossip’)
nóoskw	noun	wolverine (cf. sʼiknóon, x̱anóon)
√nuʼts	root	grin
√nuʼts	root	spoil
nútsgu	noun	spoiled smell (< √nuʼts ‘spoil’)
nóosh	noun	dead floating salmon
Anóoshi	name	Russian (<? Ru. из алюший)
nóochʼ	noun	heart of fish
√nuk	root	sg. animate sit
g̱anook	noun	petrel (< √nuk ‘sg. animate sit’)
ganx̱nook	noun	pot beside fire (< gán + √nuk ‘sg. animate sit’)
káanukjeit	noun	chair (< a káa núkji át, < √nuk ‘sg. animate sit’)
ginóok	noun	bread of the Eucharist (< *ginéikw < Ru. хлеб; cf. xunéikw)
nukt	noun	grouse
√nukts	root	sweet, delicious
√nukch	root	helpless, undependable
nóoxʼ	noun	shell
√nukʼ	root	pivot, swivel (< √nikʼw)
√nukʼ	root	in x̱ashinóokʼ ‘glossy fur’
noox̱ú	noun	colon (cf. ḵʼanoox̱)
ḵʼanoox̱	noun	labret; whiskers of fish (cf. noox̱ú)
√da	root	flow
√da	root	accustomed; watch over
daa	noun	around, surrounding
daakeit	noun	container (< daa ‘around’ + ká + át; see -keit)
kaldaag̱ákw	adv	naked (< daa ‘around’ + -ḵ ‘lacking’ + -ákw?)
kaldaag̱éináx̱	adv	slowly, carefully (<? daa ‘around’)
daa	pron	what (wh-question)
daat	pron	what (wh-question; < daa ‘what’ + -t)
dáa	noun	weasel (cf. kóoshdaa ‘land otter’)
dáa	pcl	let it be so; (cf. dáashéiwéixʼ ‘be quiet, that’s enough’)
kóoshdaa	noun	land otter (cf. dáa ‘weasel’)
√daʼÿ	root	exclaim, scold
daaw	noun	broad kelp
daawáa	noun	Indian chess (<? √daʼÿ or √da)
√daawáa	root	play Indian chess (< daawáa)
dám	interj	bang
√daʼn	root	snow fall heavily (cf. kadánjaa ‘dust’, √dan ‘pile up’)
kadánjaa	noun	dust
Dánjaakʼ	name	Donjek River (reinterp.)
√dan	root	pile up (cf. √daʼn ‘snow fall heavily’)
séewkooshdaneit	noun	swallow (cf. sinkooshdaneit, < séewkooshtaneit)
sinkooshdaneit	noun	swallow (cf. séewkooshdaneit, < séewkooshtaneit)
kadáan	noun	fine, excellent (cf. ḵooshkadáan)
ḵooshkadáan	interj	alas, oh no, distress (cf. kadáan)
Wáashdán	name	American (< CJ báštən < Eng. Boston)
dáanaa	noun	money, silver, coin, circular (< CJ dála < Eng. dollar)
waḵdáanaa	noun	eyeglasses (< waaḵ ‘eye’ + dáanaa ‘silver, coin’)
√dáanaa	root	rich, wealthy (< dáanaa ‘money’)
geewdáan	noun	horse (< CJ kiyudán < unknown)
giwdáan	noun	horse (< CJ kiyudán < unknown)
gawdáan	noun	horse (< giwdáan < CJ kiyudán < unknown)
gamdáan	noun	horse (< gawdáan < giwdáan < CJ kiyudán < unknown)
√daʼt	root	bounce back
dáat	noun	jelly (< √daʼt ‘bounce back’)
√dat	root	bruised
sheinjoosdaadí	noun	kind of rock causing rain
√dal	root	heavy (cf. √das ‘too light’)
atdáli	noun	pound (< √dal ‘heavy’)
dáali	noun	tripe
√dalʼ	root	imprint; type (cf. √dasʼ ‘wear through’)
kadáalʼi	noun	imprint (< √dalʼ ‘imprint’)
waḵkadáalʼi	noun	folded open eyelid (< waaḵ ‘eye’ + √dalʼ ‘imprint’)
kaldáalʼi	noun	typist (< √dalʼ ‘imprint’)
shkaldálʼx̱.át	noun	typewriter (< √dalʼ ‘imprint’)
√das	root	too light (cf. √dal ‘heavy’)
daádzi	noun	flint, fire-striking stone; testicles
xóotsdáadzi	noun	Lapland longspur (< dáadzi ‘testicles’)
√dasʼ	root	wear through; snare (cf. √dalʼ ‘imprint’)
dáasʼaa	noun	snare (< √dasʼ + -áa)
√dasʼ	root	hail
kadásʼ	noun	hail (< √dasʼ ‘hail’)
kʼoodásʼ	noun	shirt (cf. √dalʼ ‘imprint’, √dasʼ ‘wear through’)
goodásʼ	noun	shirt (< kʼoodásʼ)
dáxw	noun	lowbush cranberry (cf. dúx)
dákwl	noun	fish split and hung to dry
√dak	root	bake in pit (cf. √dakw ‘render’)
√dak	root	croak like frog
dáak	dirn	out to sea (cf. dák, deikée)
dák	dirn	out to sea (cf. dáak, deikée)
deikée	dirn	out to sea (cf. dáak, dák)
diginaa	noun	out to sea (< deikée + niÿaa)
Deikeenaa	name	Haida (< deikée + naa)
ixdáaknáx̱.á	noun	south side inside house toward beach (< éex + dáak)
√dakw	root	render fat
dakwtási	noun	fertilizer (< √dakw ‘render’ + -tási unknown)
nadáakw	noun	table (< CJ lətáp < Fr. la table)
-dáx̱	ppn	from, out of, ablative
dax̱-	affix	distributive in verbs (cf. dag̱a-, -g̱áa)
dáx̱-	num	two, compounding form of déix̱ ‘two’
dáx̱náx̱	num	two people (< dáx̱- + -náx̱)
√dax̱	root	hew with adze
dáax̱	noun	canoe under construction (< √dax̱ ‘hew with adze’)
√daʼx̱	root	move under momentum
shaÿadáax̱	adv	better/more than before; again (cf. shuwadáax̱)
shuwadáax̱	adv	better/more than before; again (cf. shaÿadáax̱)
dag̱a-	affix	distributive in verbs (cf. dax̱-, -g̱áa)
√daḵ	root	clear up
√daḵ	root	move residence (perh. related to √daḵ ‘clear up’)
shax̱dáḵ	noun	kind of shark; kind of beetle (cf. shuḵdáḵ)
shuḵdáḵ	noun	kind of shark; kind of beetle (cf. shax̱dáḵ)
dáaḵ	dirn	inland, away from open (cf. dáḵ, deiḵ)
dáḵ	dirn	inland, away from open (cf. dáaḵ, deiḵ)
deiḵ	dirn	inland, away from open (cf. dáaḵ, dáḵ)
daaḵw	pron	which (wh-question; < daaḵu)
daaḵu	pron	which (wh-question; < daa or daat + ḵu)
daax̱ʼwaa	pron	which one (wh-question; < daaḵw + aa)
daaḵw.aa	pron	which one (wh-question; < daaḵw + aa)
daaḵwaa	pron	which one (wh-question; < daaḵw + aa) 
daag̱waa	pron	which one (wh-question; < daaḵw + aa) 
daaḵwei	pron	which one (wh-question; < daaḵw + aa)
daaḵw.át	pron	what kind (wh-question; < daaḵw + át)
daaḵwát	pron	what kind (wh-question; < daaḵw + át)
daaḵweit	pron	what kind (wh-question; < daaḵw + át)
dei	noun	road, trail, path
de	adv	now, already (cf. dei ‘now, already’)
dei	adv	now, already (cf. de ‘now, already’)
déi	interj	now (cf. dei ‘now, already’)
dé	interj	now (cf. dei ‘now, already’)
dei-	affix	out to sea (in deikée, cf. dáak)
ḵashde	pcl	had thought (< x̱ach + de ‘now’, see x̱ach)
x̱ashde	pcl	had thought (< x̱ach + de ‘now’, see x̱ach)
shákdé	pcl	perhaps (<? shí ‘dubitative’ + gí ‘yes/no’ + de ‘now’)
ḵʼanashgidéi	adv	poor (< sh-*√de unknown <? *√day or *√daÿ or *√di)
chudéi	noun	tomcod
tlʼaag̱eendéi	noun	leech
táatlʼeeshdéi	noun	blackbird
déin	noun	area, vicinity (cf. -déin)
-déin	affix	adverbial suffix (< déin ‘area, vicinity’)
-deit	affix	thing (< -di + át; cf. -weit, -ÿeit, -neit, -teit, -jeit)
√del	root	protect, guard
déili	noun	harbour (< √del ‘protect, guard’)
déisaa	noun	clam juice for seasoning (< *√des unknown)
√detlʼ	root	swelling of wound (also attested as √ḵetlʼ, see L73: 05/96)
√dexʼ	root	ashamed
kadéixʼ	noun	shame (< √dexʼ ‘ashamed’)
déix̱	num	two (cf. déex̱, dáx̱-)
déex̱	num	two (cf. déix̱; Yakutat dialect only)
√deḵ	root	dare
dee	noun	tea (< Eng.)
gudéeyi	noun	shallow canoe for pack ice travel
√din	root	upset, concern, trouble
deenáa	noun	seal harpoon (<? √din ‘upset, concern, trouble’)
sʼoodeen	noun	shrew
sʼikshaldéen	noun	Hudson Bay tea (< sʼeek + shá + l-*√din unknown; sʼíksh)
gukyikdínl	noun	earwax, hard of hearing (< gúk + ÿík + *√din + *-l)
shdéen	noun	steel (< CJ sdíl or Eng. steel; occ. sdéen)
shadíngaa	noun	pig (<? Ru. свинья ‘pig’ or свинина ‘pork’)
shadéengaa	noun	strings (? see L73 05/115; cf. shadíngaa ‘pig’)
dís	noun	moon, month (cf. √diʼs)
√diʼs	root	moon be visible; month change (cf. dís ‘moon’)
√dich	root	rub eyes (cf. √duch ‘rub eyes’)
deegáa	noun	dipnet (< √dik ‘dipnet’)
√dik	root	dip, fish with dipnet (cf. deegáa ‘dipnet’)
√dixʼ	root	plug, cork (cf. √dikʼ ‘constipate’)
x̱ʼadéexʼi	noun	plug, cork (< x̱ʼé ‘mouth’ + √dixʼ ‘plug’)
√dikʼ	root	constipate (cf. √dixʼ ‘plug’)
díx̱ʼ	noun	spine, back (> déx̱ʼ, dáx̱ʼ)
déx̱ʼ	noun	spine, back (< díx̱ʼ)
dáx̱ʼ	noun	spine, back (< díx̱ʼ)
lidíx̱ʼ	noun	neck (< lé ‘throat’ + díx̱ʼ ‘spine’)
ladíx̱ʼ	noun	neck (< lidíx̱ʼ)
tudéx̱ʼi	noun	backbone, vertebra(e) (< tú ‘inside’ + díx̱ʼ ‘spine’)
du	pron	third person human possessor/postposition
du-	pron	fourth person human subject
dú	noun	self; in PP dóo < dú + -xʼ and PP dóot < dú + -t (also with tú)
dú	interj	no thanks, refusal
dóo	interj	you dummy, annoyance, impatience
hadóo	interj	oh my, surprise (< hadáw)
hadáw	interj	oh my, surprise (<? *hadám, cf. dám ‘bang!’)
hadóh	interj	oh my, surprise (< hadáw)
nawadóo	noun	domestic sheep (< CJ ləmutó < Fr. le mouton)
wanadóo	noun	domestic sheep (< nawadóo < CJ ləmutó < Fr. le mouton)
√dutʼ	root	hiccup
dóol	noun	sandhill crane
gusʼyadóoli	noun	snipe, sandpiper (< góosʼ ‘cloud’ + ÿá or ÿee + dóol)
√dulʼ	root	get erection
√dutl	root	crumple, double up (from pain or cold)
√dutl	root	entice, beckon, coax to come
koodúdlaa	noun	fish coaxer (< √dutl ‘entice’)
√dutlʼ	root	roll up (cf. √duchʼ ‘tweak, roll’, √dusʼ ‘tsunami’)
√dusʼ	root	tsunami, strange sudden water movement (cf. √dutlʼ ‘roll up’)
dúsʼ	noun	soot (< √dusʼ ‘sooty’)
√dusʼ	root	sooty (cf. dúsʼ ‘soot’)
dúsh	noun	tadpole, polliwog
dúsh	noun	chub or stone perch (only from Aurel Krause)
dóosh	noun	cat (<? CJ puspús <? Eng.)
√duch	root	rub eyes (cf. √dich ‘rub eyes’)
√duchʼ	root	tweak, roll, pinch and twist (cf. √dutlʼ ‘roll up’)
√duchʼ	root	cut in chunks
dúx	noun	lowbush cranberry (< dáxw)
dóox	noun	sinew (rare; cf. tás ‘sinew, thread’)
sdóox	noun	stove (< CJ sdúf or Eng. stove; occ. shdóox)
√duk	root	closed up, solid, plugged, healed up, become whole
lit.isdúk	noun	black bass (< √duk ‘closed up, solid’)
dook	noun	skin, complexion
doogú	noun	skin (< dook)
√duk	root	clean, pure (var. of √tuk)
dákwli	noun	fish cleaned and hung to dry (also kadúkli, kaldúkl, etc.)
√duxʼ	root	tie knot
kadóoxʼ	noun	knot (< √duxʼ)
√duḵ	root	wet, slushy snow
dúḵ	noun	cottonwood, poplar; canoe made of cottonwood
tá	noun	head of bay (cf. táak ‘inside surface’)
takeit	noun	headband of wood (tá ‘head’ + ká ‘hsfc’ + át ‘thing’)
-datáan	affix	facing direction (< tá ‘head’); in ÿindatáan, kindatáan, etc.
táak	noun	inside surface (cf. tá ‘head of bay’)
tayee	noun	beneath (< tá ‘head’ or táak ‘inside surface’ + ÿee ‘below’)
√taʰ	root	sleep (cf. tá ‘sleep’)
tá	noun	sleep (cf. √taʰ ‘sleep’)
√ta	root	boil (cf. téix̱ ‘boiled food’)
téix̱	noun	boiled food (< √ta ‘boil’)
√ta	root	ice float
taaÿ	noun	fat
√ta	root	fat (cf. taaÿ ‘fat’, √táaÿ)
√táaÿ	root	fat (cf. taaÿ ‘fat’, √ta ‘fat’)
táaÿ	noun	garden
ltaaÿí	noun	ptarmigan (< Dene ʔəłdaːỹiː ‘bough eater’)
√taʼw	root	steal
táaw	noun	stealing, thievery (< √taʼw ‘steal’)
táawsán	num	thousand (< CJ táwsən or Eng. thousand)
√tan	root	handle wooden or long object or empty container
seig̱atáanaa	noun	berrying basket (< sé ‘throat’ + √tan ‘handle’)
náax̱.ag̱ataan	noun	stakes driven into bottom of stream (< √tan ‘handle’)
tundatáan	noun	thought (< tu- ‘mind’ + √tan ‘handle’)
yoox̱ʼatánk	noun	speech (< x̱ʼa- ‘mouth’ + √tan ‘handle’)
√tan	root	fish jump
√tan	root	hook squid or octopus
táanaa	noun	octopus spear (< √tan ‘hook squid or octopus’)
√tan	root	be habituated
séewkooshtaneit	noun	swallow (< séew ‘rain’ + √tan ‘habituated’)
Ḵudatán Hít	noun	Salmon Box House (< ḵu- ‘areal’ + da-√tan unknown)
√tánu	root	gripe, complain, mutter
sʼigeiditaan	noun	bat (< sʼigeidí ‘beaver’ + taan unknown)
taan	noun	sea lion
taan	noun	people of a house group (mostly in clan names)
ḵutaan	noun	summer
taanú	noun	umbilical cord (cf. taanwú, táani)
taanwú	noun	umbilical cord (cf. taanú, táani)
táani	noun	umbilical cord (cf. taanú, taanwú)
tleikatánk	noun	huckleberry (<? tléik ‘side’ + de ‘way’ + katánk ‘bent’)
taat	noun	night (cf. tatgé ‘yesterday’, nisdaat ‘lastnight’, ÿeedát ‘now’)
nisdaat	noun	last night (< nis- + taat ‘night’)
taatÿeen	noun	middle of night (< taat ‘night’ + ÿeen ‘during’)
tsʼootaat	noun	morning (<? tsʼu- + taat ‘night’)
tatgé	noun	yesterday (<? taat ‘night’)
táal	noun	flat open basket; flat thing (adj.)
tuḵʼatáal	noun	pants, trousers (< tóoḵ ‘butt’ + x̱ʼé ‘mouth’ + táal)
Taal	name	component of names referring to Tahltan
√tált	root	dissuade, discourage
tás	noun	sinew, thread
taská	noun	inguinal region (<? tás + ká)
√tats	root	knock berries from bush
kadádzaaÿeit	noun	berry knocking basket (< √tats + ÿeit)
sʼagwáattáasʼi	noun	violet (< sʼagwáat ‘hemlock bark’ + táasʼi unkn.)
√taxʼ	root	bite, chew
táaxʼi	noun	chewed up thing (< √taxʼ ‘bite, chew’ + -í)
táaxʼaa	noun	mosquito (< √taxʼ ‘bite, chew’ + -áa)
kakatáxʼaa	noun	pliers (< ká + √taxʼ ‘bite, chew’ + -áa)
táxʼx̱	noun	dentalium (cf. táxʼx̱i)
táxʼx̱i	noun	dentalium (cf. táxʼx̱)
x̱ʼeitákw	noun	heel
táakw	noun	winter; year
√táakw	root	spend winter (< táakw ‘winter’)
taakween	noun	midwinter, January (< táakw ‘winter’ + ÿeen ‘during’)
taakw.eetí	noun	spring (< táakw ‘winter’ + eetí ‘remains’)
shakeedatáxʼ	noun	white crowned sparrow (cf. shakeedatákʼ)
shakeedatákʼ	noun	white crowned sparrow (cf. shakeedatáxʼ)
√taḵ	root	poke, spear, pry
tág̱aa	noun	chisel, lancet (< √taḵ ‘poke’)
kaktág̱aa	noun	skin cleaner (< √taḵ ‘poke’)
katág̱ayi	noun	connecting rod in machine (< √taḵ ‘poke’)
shkooltág̱aa	noun	pool, billiards (< √taḵ ‘poke’)
ux̱taag̱áni	noun	canine tooth (< oox̱ ‘tooth’ + √taḵ ‘poke’)
shataag̱áa	noun	short-horned deer (< shá ‘head’ + √taḵ ‘poke’)
taag̱anís	noun	pole (< taag̱anÿís)
taag̱anÿís	noun	pole (< *taag̱án ‘poker’ < √taḵ ‘poke’ + ÿís ‘for’)
√taḵ	root	care for, look after, attend (<? √taḵ ‘poke’)
taḵsháa	noun	widow (< √taḵ ‘care for, look after’)
táḵl	noun	hammer (<? √taḵ ‘poke’ + *-l ‘instrument’)
kayeix̱tág̱u	noun	shavings (< √yex̱ ‘shave, plane’ + tág̱u unknown)
kantáḵw	noun	lupine (cf. gantáḵw; perh. -áḵw ‘lacking’)
gantáḵw	noun	lupine (cf. kantáḵw; perh. -áḵw ‘lacking’)
táx̱k	noun	bare-topped hill (<? √tax̱ ‘moisture condense’)
tax̱giluká	noun	ridge along hill (< táx̱k + lú + ká)
tax̱gixʼaa	noun	point of hill (< táx̱k + xʼaa)
√tax̱	root	moisture condense (cf. √tex̱ ‘moisture condense’)
ḵukatáx̱	noun	dew (< √tax̱ ‘moisture condense’)
katáx̱	noun	wetness on ground after dew or rain (< √tax̱ ‘moisture condense’)
kootáax̱aa	noun	headband (< √tax̱ unknown)
táax̱ʼ	noun	slug, snail
táax̱ʼ	noun	raised level around housepit (cf. tʼáax̱ʼw)
táax̱ʼw	noun	wart (cf. tʼáax̱ʼw)
√tax̱ʼw	root	sink, drown
√tax̱ʼw	root	shake (only in L78: 24)
√tax̱ʼw	root	smoke signal (cf. √tex̱ʼw)
té	noun	rock (cf. √té ‘rocky’)
√té	root	rocky (cf. té ‘rock’)
neixeenté	noun	rock used to make paint (< té ‘rock’)
teÿataaÿí	noun	sea anemone (< té + ÿá ‘face’ + taaÿ ‘fat’)
shanÿaateiÿí	noun	low tide rocks (< shanÿaa ‘low tide’ + té ‘rock’)
texʼaaÿí	noun	rocky point (< té ‘rock’ + xʼaa)
goowaté	noun	round stone for anchor (< goowa- unknown + té ‘rock’)
yéilteiyí	noun	mica (< yéil ‘raven’ + té ‘rock’)
tégéxkw	noun	pumice (< té ‘rock’ + géxkw unknown)
ḵooté	noun	medium-sized beaver (<? Dene)
ḵʼateil	noun	jug
téil	noun	pitch
téil	pcl	negative (in Teslin & Carcross; cf. tléil, tlél, tléikʼ)
√tetlʼ	root	fat (animal; cf. √tesʼ ‘limp, flabby’)
téitlʼ	noun	animal fat (< √tetlʼ; cf. taaÿ ‘fat’, téelʼ ‘dog salmon’)
suḵtéitlʼ	noun	goosetongue (< sooḵ ‘wide grass’ + téitlʼ ‘fat’)
√tesʼ	root	flabby, limp
téisʼ	noun	flab (< √tesʼ ‘limp, flabby’)
-teit	affix	thing (< -t + -i + át; cf. -ÿeit, -weit, -deit, -neit, -jeit)
√tex̱	root	moisture condense (cf. √tax̱ ‘moisture condense’)
ḵukatéx̱	noun	dew (< √tex̱ ‘moisture condense’)
√tex̱	root	smell acrid
yéiltéx̱i	noun	wild onion (< √tex ‘smell acrid’)
teiḵ	noun	cape (clothing; cf. teeḵ)
téix̱ʼ	noun	heart (cf. √tex̱ʼ ‘twist’)
Gutéix̱ʼ	name	Eyak (cf. Haida kʼudeeḵʼ)
√tex̱ʼw	root	smoke signal (cf. √tax̱ʼw)
√teʼḵ	root	twist (cf. √tex̱ʼ, √tix̱ʼ, √tiḵʼ, √tixʼ ‘twist rope’)
√tex̱ʼ	root	twist (< √tix̱ʼ; cf. √teʼḵ, √tiḵʼ, téix̱ʼ ‘heart’)
√tiḵʼ	root	twist (cf. √tex̱ʼ, √teʼḵ, √tix̱ʼ, √tixʼ ‘twist rope’)
√tiʰ	root	handle generic object
√tiʰ	root	exist, be
tee	noun	tea (< Eng.)
shachkalateeÿí	noun	sʼikshaldéen, Hudson’s Bay tea (<? sháchk + tee ‘tea’)
√tiÿ	root	soak fish
téeÿi	noun	soaked fish (< √tiÿ ‘soak fish’)
√tiʼÿ	root	patch
téeÿ	noun	patch (< √tiʼÿ ‘patch’)
√tiʼÿ	root	carve with chisel or adze
tíÿaa	noun	chisel (< √tiʼÿ ‘carve with chisel or adze’)
kootéeÿaa	noun	totem pole (< √tiʼÿ ‘carve with chisel or adze’)
√tiʼÿ	root	jealous of spouse
téeÿ	noun	chin
√tiʼw	root	count, read (> √tuʼw)
teen	ppn	with, instrumental postposition (< át? + ee + -n, cf. een, -n)
tin	ppn	with, instrumental postposition (< teen)
√tin	root	see; travel
ḵutéen	noun	sight (< √tin ‘see’)
latíni	noun	watcher (< √tin ‘see’)
√tin	root	go away mad (with a-)
ḵustín	adj	monstrous, giant
√tín	root	in wudzitínxʼ ‘lots of makeup on’ (< Eng. thing + -xʼ ‘plural’)
tináa	noun	copper shield (< √tin unknown + -áa)
tínx	noun	bearberry
√tit	root	wave move (cf. teet ‘wave’)
teet	noun	waves (cf. √tit ‘wave move’)
yaakwdaateedí	noun	wake of boat (< yaakw ‘boat’ + daa + teet ‘wave’ + -í)
√títgwaa	root	rock easily, rapidly (< √teet ‘wave move’ + -kw + -áa)
√tit	root	caulk
téet	noun	caulk
√titʼ	root	tense up
téetʼi	noun	vein (< √titʼ ‘tense up’)
jaḵtawteetʼí	noun	murderer (<? √jaḵ ‘kill’ + taw? + √titʼ ‘tense up’)
√til	root	scarred
teel	noun	scar
√til	root	put on shoes (cf. téel ‘shoe’)
téel	noun	shoe (cf. √til ‘put on shoes’)
téelʼ	noun	dog salmon (cf. téisʼ ‘flab’, téitlʼ ‘fat’)
√tis	root	shuffle, make audible footsteps (cf. √tixw, √tux)
√tis	root	make fun, mock, tease
√tisʼ	root	watch for, look, stare (cf. √tin ‘see’)
katísʼayi	noun	large snowflakes (<? √tisʼ ‘watch for, look, stare’)
Ḵutéesʼ	name	in Ḵutéesʼ Hít ‘Look Out House’
√tish	root	lonely, lonesome
√tix	root	have fleas (cf. tíx ‘flea’, wanatíx ‘ant’)
tíx	noun	flea (cf. √tix ‘have fleas’, wanatíx ‘ant’)
wanatíx	noun	ant (cf. tíx ‘flea’, √tix ‘have fleas’; or <? CJ)
stixáa	noun	sticharion, cassock (< Ru. стихарь < Gk. στιχάριον)
√tixw	root	stamp feet (> √tux; cf. √tis ‘shuffle’)
tíxwjaa	noun	stamping noise (< √tixw ‘stamp feet’)
tíxʼ	noun	rope, cord (cf. √tixʼ ‘twist into rope’)
√tixʼ	root	twist into rope (cf. tíxʼ ‘rope’)
teeḵ	noun	cape (clothing; cf. teiḵ)
√tix̱ʼ	root	twist, wring, wind (> √tex̱ʼ; cf. √tixʼ, √teʼḵ, √tiḵʼ)
katíx̱ʼaa	noun	key (< √tix̱ʼ ‘twist’)
tú	noun	inside hollow object (cf. toowú)
tatóok	noun	cave (< tú ‘inside hollow object’)
toowú	noun	mind, emotion, spirit, soul (cf. tú)
tu-	noun	mind, emotion, spirit, soul (< toowú)
tu-	pron	first person plural subject
tú	noun	self; in PPs like tóo < tú + -xʼ (cf. dú)
√tu	root	clever
tú.á	interj	smart move, good one (sarcastic?)
toow	noun	tallow (< *tuʰm)
kintóow	noun	icicle (cf. kintóodzi)
tóotʼ	noun	wood waste from chopping tree? (L78: 26)
√tul	root	drill; spin; roll up (cf. √duchʼ, √dutlʼ, √dusʼ, √tuʼl)
túlaa	noun	drill (< √tul ‘drill, spin’)
√tuʼl	root	murmur (cf. √tul ‘drill; spin’)
tóol	noun	timbered hill or ridge
tóotlʼáḵw	noun	clam-drying frame (cf. -áḵw ‘lacking’)
tóosʼ	noun	shark
kintóodzi	noun	icicle (cf. kintóow, katóodzi, kʼiyeetóodzi)
katóodzi	noun	icicle (cf. kintóow, kintóodzi, kʼiyeetóodzi)
kʼiyeetóodzi	noun	icicle (cf. kintóow, kintóodzi, katóodzi)
√tuch	root	freshly caught (fish)
tóoch	adj	fresh
√tuchʼ	root	rub with hand, dab, roll up (cf. √dutlʼ, √duchʼ, √dusʼ, √tul)
√tux	root	insect spring, hop (cf. √tix, √tixw)
tóox	noun	sandflea, bedbug (< √tux; cf. tíx, wanatíx)
jáajikatúxsi	noun	snowshoe frame (< √túxs unknown; <? Dene)
tuxʼ-	affix	knee in yan tuxʼ uwatsúw ‘he knelt down’
√tuk	root	explode
√tuk	root	brew too strong, rancid; clean, pure (with negation)
√tux̱	root	spit
leitóox̱	noun	throat (< lé ‘throat’ + √tux̱ ‘spit’)
tooḵ	noun	needlefish
tóoḵ	noun	butt
túḵlʼ	noun	small conifer (cf. dúḵ ‘cottonwood’)
lututúḵlʼi	noun	nose cartilage (< lú ‘nose’ + tú ‘inside’ + túḵlʼ)
√tux̱ʼ	root	squirt, spit up; ink (octopus, squid)
√tux̱ʼ	root	rumble, growl (stomach)
shtóox̱ʼ	noun	ankle (< shutóox̱ʼ)
shutóox̱ʼ	noun	ankle
-tʼ	affix	repetitive suffix on verbs, usually involving destruction
√tʼaʰ	root	hot
tʼaaÿ	noun	hotsprings; heat; perspiration (cf. √tʼaʰ ‘hot’)
√tʼaʰ	root	ripe (<? √tʼaʰ ‘hot’)
kanatʼá	noun	blueberry (< √tʼaʰ ‘ripe’)
√tʼaʰ	root	warp, bend by steam or heat (cf. √tʼak ‘dent’)
tʼá	noun	king salmon
-tʼaa	affix	one (in demonstratives; < -t + aa ‘partitive’)
-tʼát	affix	thing (in demonstratives; < -t + át ‘thing’)
tʼáa	noun	board (cf. √tʼaʼÿ ‘shiplap’)
√tʼaʼÿ	root	shiplap, layer with boards, skirt house (cf. tʼáa ‘board’)
tʼáak	noun	behind, back from, landward of (cf. tʼéik, √tʼeʰ)
tʼaaw	noun	feather
tʼaawáḵ	noun	goose (< tʼaaw ‘feather’ + -áḵ ‘lacking’)
Tʼaawyáatʼ	name	Long Feather; also applied to Plains Indians
tʼáaw	noun	thwart, canoe crosspiece (perh. √tʼaʰ ‘bend by steam’)
√tʼan	root	expect, anticipate
tʼáni	noun	limb, branch (cf. tʼaan)
tʼaan	noun	stitch; line on skin; weft, woof of weaving (cf. tʼáni)
ḵaasistʼaan	noun	spider (< tʼaan ‘stitch’)
ltʼaaní	noun	earth, world (< lingít + aaní)
ltʼaaniká	noun	country (< ltʼaaní + ká)
√tʼatʼ	root	pat out (cf. √tʼak, √tʼalʼ, √tʼach, √tʼatl, katʼátʼx̱i ‘patty’)
katʼátʼx̱i	noun	patty (< √tʼatʼ)
kastʼáatʼ	noun	quilt (< √tʼatʼ)
tʼáatʼ	noun	junco
√tʼalʼ	root	flat, mash (cf. √tʼak, √tʼatʼ, √tʼatl, √tʼach, √tʼash, √tʼakw)
√tʼatl	root	splash, slap water (cf. √tʼak, √tʼatʼ, √tʼalʼ, √tʼach)
tʼási	noun	grayling (<? Dene)
√tʼasʼ	root	look askance, snap eyes at
√tʼach	root	slap, clap, swim (cf. √tʼash, √tʼak, √tʼatʼ, √tʼatl, √tʼalʼ)
√tʼash	root	slap, clap, swim (cf. √tʼach, √tʼak, √tʼatʼ, √tʼatl, √tʼalʼ)
√tʼak	root	dent, press into cake (cf. √tʼatʼ, √tʼatl, √tʼash, √tʼakw)
katʼákx̱i	noun	patty (cf. √tʼak, √tʼatʼ, katʼátʼx̱i)
√tʼakw	noun	slap tail, hit hard (cf. √tʼak, √tʼatʼ, √tʼach)
katʼákwjaa	noun	fan (< √tʼakw)
yakatʼájaa	noun	fan (< √tʼakw)
√tʼakw	root	body heat
katʼákwjaa	noun	body heat (< √tʼakw)
yatʼákw	noun	temple (< √tʼakw)
√tʼaxʼ	root	clip, click, cut pieces; flick
kootʼáaxʼaa	noun	marble (< √tʼaxʼ)
x̱ʼeintʼáaxʼaa	noun	labret (< √tʼaxʼ)
√tʼaḵ	root	shift position, move slightly
√tʼax̱	root	open mouth
√tʼaḵ	root	add extra (cf. tʼaaḵ ‘beside’)
tʼaaḵ	noun	beside (cf. √tʼaḵ ‘add extra’, tʼaag̱í ‘comrade, clansman’)
tʼaag̱í	noun	comrade, fellow, clansman, cousin (cf. tʼaaḵ ‘beside’)
tʼáḵlʼi	noun	part of it (rare)
x̱ʼustʼáḵlʼi	noun	anklebone (cf. tʼáḵlʼi)
tʼáaḵw	noun	joist, timber
tʼáag̱u	noun	joint (carpentry)
√tʼax̱ʼ	root	pop, spark
katʼáx̱ʼjaa	noun	spark, ember popped out of fire
√tʼax̱ʼ	root	heat radiate
tʼáax̱ʼw	noun	wart (cf. táax̱ʼw)
tʼáax̱ʼw	noun	raised platform (cf. táax̱ʼ)
√tʼeʰ	root	find (< √tʼiʰ)
√tʼeʰ	root	remain back (cf. tʼéik, tʼáak)
√tʼeitʼáḵw	root	multicoloured, patchwork (< √tʼV + -tʼ + -áḵw ‘lacking’)
tʼéik	noun	behind, out of sight (cf. √tʼeʰ, tʼiká, tʼáak)
tʼeinÿaa	noun	lining (< tʼéik + niÿaa)
√tʼex̱	root	fish with hook
tʼeix̱	noun	fishhook (< √tʼex̱)
tʼeix̱áa	noun	fishhook (< √tʼex̱)
astʼeix̱í	noun	fisherman; troller
√tʼex̱ʼ	root	pound, beat, hammer (< √tʼix̱ʼ)
tʼiká	noun	seaward side, outskirts (< tʼéik, cf. √tʼeʰ, tʼáak)
√tʼiʰ	root	find
√tʼéet	root	beachcomb, look for things (< √tʼiʰ ‘find’ + -t)
√tʼiʼÿ	root	elbow (cf. tʼéeÿ ‘elbow’)
tʼéeÿ	noun	elbow (cf. √tʼiʼÿ ‘elbow’)
tʼeeÿshú	noun	elbow tip (< tʼéeÿ ‘elbow’ + shú ‘end’)
tʼéetx	noun	barrel-shaped fish trap
tʼílx̱	noun	something flimsy; in tʼílx̱i yáx̱ yatee ‘it’s flimsy’
√tʼish	root	stretch skin
tʼéesh	noun	tanning frame (cf. √tʼish ‘stretch skin’)
tʼéeshkaa	noun	square (< tʼéesh ‘tanning frame’ + kaaÿ ‘measure’)
tʼéeshkaaÿ	noun	square (< tʼéesh ‘tanning frame’ + kaaÿ ‘measure’)
katʼíshaa	noun	leather needle, awl (< √tʼish ‘stretch skin’)
√tʼik	root	paddle alone, steer with paddle (cf. √dik)
tʼeegáa	noun	rudder (< √tʼik ‘paddle’)
√tʼik	root	stiff, rigid (cf. √tʼixʼ ‘hard, freeze, steady’)
√tʼixʼ	root	hard, freeze, steady (cf. √tʼik ‘stiff, rigid’)
tʼéexʼ	noun	ice (cf. √tʼixʼ ‘hard, freeze, steady’)
sh.iltʼíxʼx̱.át	noun	freezer (< √tʼixʼ ‘hard, freeze, steady’)
√tʼix̱ʼ	root	pound, beat, hammer
katʼíx̱ʼaa	noun	pestle (< √tʼix̱ʼ ‘pound, beat, hammer’)
katʼíx̱ʼaÿeit	noun	mortar (< katʼíx̱ʼaa + -ÿeit < ÿee + át)
tʼéex̱ʼi	noun	smith; in dáanaa tʼéex̱ʼi ‘silversmith’ (< √tʼix̱ʼ ‘pound’)
ḵʼeishtʼóo	noun	ball of pitch; larval cyst on caribou hide (< √ḵʼesh)
katʼóot	noun	nearly, part way, just short; waist
√tʼusʼ	root	toast, roast by fire (cf. √tʼuchʼ ‘char’, tʼoochʼ ‘charcoal’)
tʼóosʼ	noun	roasted thing (< √tʼusʼ)
datʼóosʼi	noun	baker (< √tʼusʼ)
√tʼuch	root	sting (cf. √tʼuʼk ‘shoot with arrow’, tʼóokʼ ‘nettles’)
√tʼuchʼ	root	char, blacken (cf. tʼoochʼ)
tʼoochʼ	noun	charcoal, black (cf. √tʼuchʼ)
Duktʼootlʼ	name	Strong Man (< dook ‘skin’ + tʼootlʼ cf. tʼoochʼ)
√tʼuʼk	root	shoot with arrow (cf. √tʼuch ‘sting’, tʼóokʼ ‘nettles’)
tʼúgwaa	noun	bow and arrow
tʼook	noun	cradleboard (cf. tʼukanéiÿi ‘baby’)
tʼóokʼ	noun	nettle
√tʼukʼ	root	stung by nettle (rare; cf. tʼóokʼ ‘nettle’, √tʼuch ‘sting’)
tsʼantʼookʼ	noun	bone dish (< Ahtna, cf. Dene *tsʼən-tsʼaːkʼ)
l	pcl	negative (cf. tléil, tlél, téil, héil, hél, tléikʼ)
√la	root	tide go out (cf. lein ‘tideflat’, √la ‘melt, thaw’)
lein	noun	tideflat, mudflat (< √la ‘tide go out’)
√la	root	melt, thaw
hintaklaléisʼi	noun	first run king salmon (< héen + táak + √la ‘melt’)
√la	root	yell, cheer (cf. lá ‘nape of neck’, lé ‘throat’)
lá	noun	nape of neck (cf. lidíx̱ʼ ‘neck’, lé ‘throat’)
laká	noun	inside mouth (< lé ‘throat’)
x̱ʼasʼlaaÿee	noun	area under jaw (< x̱ʼásʼ ‘jaw’ + lé ‘throat’)
laakaayí	noun	gill (< lé ‘throat’)
lakʼíchʼ	noun	back of head, nape of neck (lá ‘nape of neck’)
lé	noun	throat; only in compounds (cf. lá ‘nape of neck’, √la ‘yell’)
lekachóox̱ʼ	noun	trachea, windpipe (< lé ‘throat’ + chóox̱ʼ ‘fat roll’)
laaÿig̱águ	noun	ring finger (cf. laag̱ák ‘rock slime’)
Laaÿineidí	name	Raven moiety (<? laan unknown + ÿee + -eit)
laaw	noun	penis
laan	noun	in g̱ax̱laan ‘rabbit blanket’ and laanáḵw ‘barren cow’
g̱ax̱laan	noun	rabbit fur blanket (< g̱áx̱ ‘rabbit’ + laan unknown)
laanáḵw	noun	barren cow (< laan unknown + -áḵw ‘lacking’)
√laxw	root	starve (cf. laaxw ‘starvation’)
laaxw	noun	starvation (cf. √laxw ‘starve’)
láak	noun	fish filet (cf. ganláak ‘dry inner part of firewood’)
ganláak	noun	dry inner part of firewood (< gán ‘firewood’ + láak ‘filet’)
√lax̱	root	tree or bush die; boat be old and rotten
láax̱	noun	standing dead tree, widowmaker (cf. √lax̱ ‘tree die’)
kux̱ʼláax̱	noun	dried yaana.eit (cf. √lax̱ ‘tree die’)
√lex̱w	root	plant wither, die (cf. √lax̱ ‘tree die’)
laax̱	noun	red cedar
lax̱tʼáa	noun	red cedar boards (< laax̱ ‘red cedar’ + tʼáa ‘board’)
laag̱ák	noun	rock slime, algae that grows on rocks
laaḵʼásk	noun	black seaweed, dulse
láḵt	noun	bentwood box
láx̱ʼ	noun	heron
láx̱ʼloowú	noun	swamp blueberry (< láx̱ʼ ‘heron’ + lú ‘nose’)
láx̱ʼ	noun	membrane (cf. láx̱ʼi ‘sap’, sáxʼ ‘cambium’, xʼúxʼ ‘membrane’)
láx̱ʼi	noun	sap, inner bark, sapwood (cf. sáxʼ ‘cambium’)
ganláx̱ʼ	noun	wet outer wood (< gán ‘firewood’ + láx̱ʼ ‘membrane’)
shaláx̱ʼ	noun	dura mater, inside of skull (< shá ‘head’ + láx̱ʼ ‘membrane’)
lax̱ʼyeit	noun	trailing blackcurrant (< láx̱ʼ + -ÿeit)
√leʰ	root	far, distant (< √liʰ; cf. √seʰ ‘near’)
naliyé	noun	distant place (< naaleiyi yé ‘place that is distant’)
kalé	adj	fine, excellent
kalé	noun	membrane on fish eggs
√letʼ	root	slide (see √tletʼ)
√lel	root	loose, flabby, baggy, deflated (cf. leilí ‘baggy, scrotum’)
leilí	noun	baggy; scrotum (cf. √lel ‘flabby, baggy’)
daaleilí	noun	elephant skin, loose skin (< daa ‘around’ + leilí)
létlʼk	noun	soft (cf. lélʼk, √lel, leilí)
lélʼk	noun	soft (cf. létlʼk, √lel, leilí)
lékwaa	noun	fighting spirit
√lex̱ʼw	root	paint red (cf. √sex̱ʼw ‘stain’, léiḵʼw, léiḵʼw, shéix̱ʼw, shoox̱ʼ)
léix̱ʼw	noun	red face paint (cf. √lex̱ʼw)
kooléix̱ʼwaa	noun	walrus (< √lex̱ʼw)
léiḵʼw	noun	red snapper (cf. √lex̱ʼw, √sex̱ʼw, léix̱ʼw, shéix̱ʼw, shoox̱ʼ)
√liʰ	root	far, distant (cf. √leʰ ‘far’, √seʰ ‘near’)
ilí	interj	don’t, stop (cf. l ‘negative’, líl ‘prohibitive’)
líl	pcl	prohibitive (cf. l ‘negative’, ilí ‘don’t’)
lisʼé	interj	wait, stop (< líl + sʼé)
lingít	noun	person, Tlingit (< leengít < *ɬiʰngit < *ɬinagit, -git unknown)
leengít	noun	person, Tlingit (< *ɬiʰngit < *ɬinagit, -git unknown)
√lit	root	throw small plural objects, slide, slit (cf. lítaa ‘knife’)
lítaa	noun	knife (cf. √lit ‘slit’)
leet	noun	ridge (cf. √lit ‘slide, slit’, leedí ‘dorsal fin’)
leedí	noun	dorsal fin (cf. leet ‘ridge’)
litká	noun	atop ridge (< leet + ká)
leet	noun	Sitka spruce canoe (cf. seet ‘Sitka spruce canoe’, √lit ‘slide’)
léetʼ	noun	plant(s) used for basket weaving decoration
léelkʼw	noun	grandparent (cf. lílákʼw, áali, √.aʼl)
lílákʼw	noun	grandparent (cf. léelkʼw, áali, √.aʼl)
√léelkʼwhás	root	become grandparent (< léelkʼw ‘grandparent’ + hás ‘pl.’)
√lilʼ	root	pull along length of sticklike object
√lik	root	have defect (only in L73: 08/55)
√lik	root	dazzle, glare (cf. √likw ‘dazzle, glare’)
√likw	root	dazzle, glare (cf. √lik ‘dazzle, glare’)
√lixʼw	root	urinate (> √luxʼ; cf. lóoxʼ ‘urine’)
√luxʼ	root	urinate (< √lixʼw’; cf. lóoxʼ ‘urine’)
lóoxʼ	noun	urine (< *liˀxʼw; cf. √luxʼ ‘urinate’)
kalóoxʼshani	noun	bladder (cf. √luxʼ ‘urinate’)
√likʼw	root	slurp meat out of shellfish
lú	noun	nose, point, tip
at.luxʼaa	noun	head of trouble (< at + lú + xʼaa)
tleilú	noun	butterfly
√luʼn	root	close eyes
looní	noun	outer bark
lóotʼ	noun	eel (cf. lʼóotʼ ‘tongue’)
lóol	noun	fireweed
ÿalooleit	noun	cockle (< ÿa- + √lul unknown + -i + át, cf. -eit)
√luk	root	sip, slurp hot drink
√luk	root	have dishpan hands (only L78: 30)
√lux̱	root	drip in steady stream
kalóox̱jaa	noun	fast dripping (< √lux̱)
dláa	interj	exasperation, irritation
hadláa	interj	exasperation, irritation
√dla	root	sediment settle (cf. √dlex̱ʼw, √tle ‘strain’, √cha ‘strain’)
dlaakʼ	noun	man’s sister (cf. tláa ‘mother’)
dlákʼ	noun	sister! (< dlaakʼ)
√dlan	root	deep
√dlakw	root	scratch
dlágwaa	noun	peavy (< √dlakw ‘scratch’, cf. dlaagwáa)
dlaagwáa	noun	salmon harpoon (< √dlakw ‘scratch’, cf. dlágwaa)
√dlaxʼw	root	coil
√dlaḵ	root	overcome, succeed, win, gain
√dlax̱ʼw	root	sediment settle (see √dlex̱ʼw)
anaax̱adléi	noun	myth (only in L73: 08/94)
√dlex̱ʼw	root	sediment settle (cf. √dla, √tle ‘strain’, √cha ‘strain’)
√dlénx̱aa	root	tempt, test (cf. √dlénaa)
√dlénaa	root	play touching game (cf. √dlénx̱aa)
dleit	noun	snow (< √dla ‘settle’ + át ‘thing’)
√dlèit	root	snowy (< dleit ‘snow’)
√dletʼ	root	plop (cf. √dletlʼ ‘hang slackly’)
√dletlʼ	root	hang slackly (cf. √dletʼ ‘plop’)
√dlexw	root	skin peel esp. with thumb (< √dlixw)
√dlekw	root	startle, shock (cf. √jech)
√dleʼkw	root	pat, shake hand (cf. dleigú ‘lullaby’, √dléigu)
√dléigu	root	pat, shake hand (see √dleʼkw)
dleigú	noun	lullaby (cf. √dleʼkw, √dléigu)
dleeÿ	noun	meat, flesh, muscle
√dleeÿí	root	muscular, meaty (< dleeÿ)
dleewkát	adv	carefully (cf. dloonkát)
dloonkát	adv	carefully (cf. dleewkát)
√dlixw	root	skin peel esp. with thumb (> √dlux; cf. √dlexw)
haashdlóo	interj	surprise (cf. dláa, hadláa, hadóo)
haadlóo	interj	surprise (cf. dláa, hadláa, hadóo)
hadlóo	interj	surprise (cf. dláa, hadláa, hadóo)
hadlóh	interj	surprise (cf. dláa, hadláa, hadóo)
hadláw	interj	surprise (cf. dláa, hadláa, hadóo)
yakadlúwaas	noun	bloomers (< yá + ká + Eng. bloomers)
dlóotldáx̱	adv	on one’s own (< dlóotl unknown + -dáx̱ ‘ablative’)
dlóodlidáx̱	adv	on one’s own
dlóotlkʼidáx̱	adv	on one’s own
√dlux	root	skin peel esp. with thumb (< √dlixw)
√dluḵ	root	sticky, gooey
waḵkadlóog̱u	eye mucus (< waaḵ ‘eye’ + ká + dlóoḵ < √dluḵ)
tla-	affix	in tlag̱eiÿí ‘brain’ (cf. shá ‘head’)
tlag̱eiyí	noun	brain (< tla- + g̱ei ‘between, within’ + -í)
√tla	root	sediment settle (cf. √dla)
√tlaʰ	root	stout, big around, thick; comforting with tu-
-tlei	affix	irregular stem form of √tlaʰ ‘stout’
tlein	adj	big, large (< √tlaʰ ‘stout’ + -n, cf. -tlei)
aatlein	adv	much, lots (< aa + tlein)
tlénxʼ	adj	pl. big, large (< tlein + -xʼ)
tulatlei	noun	comfort (< √tlaʰ, cf. -tlei)
tláa	noun	mother (cf. atlée, tláakʼw, dlaakʼ)
atlée	noun	mommy (<? ax̱ tláa, cf. atléi)
atléi	noun	mommy (<? ax̱ tláa, cf. atlée)
tláakʼw	noun	mother’s sister (< tláa + -kʼ, cf. dlaakʼ)
tlám	interj	bang, thump (> tlóo)
tlóo	interj	bang, thump (< tlám)
tláxchʼ	noun	dead branch without needles or leaves
√tlak	root	quieten, shush
tlákw	adv	always in the past (cf. tlaagú, √tlakw, tlágu, tleix̱; √tsáakw)
tlaagú	noun	legend, legendary; in chʼa tlaagú ‘amazing!’ (cf. tlákw, √tlakw)
tlágu	adj	old, ancient (cf. tlákw, √tlakw, tlaagú, chʼáagu)
√tlakw	root	investigate; tell legend; whisper with ḵu- (cf. tlákw, tlaagú)
tláakw	adv	quickly; in anger
tláaḵ	noun	sharp point of arrow, spear
lʼutʼtláaḵ	noun	snake, serpent (< lʼóotʼ ‘tongue’ + tláaḵ ‘spearpoint’)
tláx̱	adv	very, extremely
√tlax̱	root	mouldy, moldy (cf. tlaax̱ ‘mould’)
tlaax̱	noun	mould, mold growth (cf. √tlax̱)
shaltláax̱	noun	rock almost covered by tide (< shá + l- + √tlax̱)
tle	pcl	and so, just
√tle	root	strain (cf. √dla, √cha, √dlex̱ʼw
√tleʰ	root	stout (< √tlaʰ)
√tle	root	run away, avoid responsibility (only in L78: 32)
√tlew	root	make noise, yell or speak loudly
√tletʼ	root	lick; slip
√tleilkʼú	root	make string figures (< tleilkʼú)
tleilkʼú	noun	string figures (cf. √tleilkʼú)
tléil	pcl	negative (cf. héil, hél, l)
tlél	pcl	neggative (< tléil)
tléikʼ	interj	no (cf. tléil, héil, l)
tléixʼ	num	one
tléináx̱	num	one person (< tléikʼ + -náx̱)
tléig̱aa	num	one each (< tléikʼ + -g̱áa)
tleix̱	adv	always in the future (cf. tlákw)
√tlex̱w	root	plunge, scare fish with plunger
tléiḵw	noun	berry (cf. √tleḵw ‘grab one at a time’)
√tleḵw	root	grab one at a time (cf. tléiḵw ‘berry’)
√tleḵw	root	greedy, gluttonous, excessively
√tluxʼ	root	pull or roll self; carry clutched
tlóox̱	noun	bullhead, sculpin (cf. tlóox̱ʼ)
tlóox̱ʼ	noun	bullhead, sculpin (cf. tlóox̱)
-lʼ	affix	repetitive suffix on verbs (cf. -álʼ)
-álʼ	affix	repetitive suffix on verbs (cf. -lʼ)
√lʼaʰ	root	suck (cf. lʼaa ‘breast’)
lʼaa	noun	breast (cf. √lʼaʰ ‘suck’)
lʼaatux̱áni	noun	milk (< lʼaa ‘breast’ + tú ‘inside’ + x̱án unknown + -í)
lʼáa-	affix	in lʼáadu ‘inner part of spruce root’ and tulʼáadu ‘foundation’
lʼáadu	noun	inner part of spruce root (cf. lʼáadu)
tulʼáadu	noun	foundation of house (< tú ‘inside’ + lʼáadu)
tulʼáatx̱u	noun	foundation of house (cf. tulʼáadu)
lʼaw-	affix	in lʼawshadaaÿí ‘war helmet’ (in L73: 08/170)
lʼán	noun	in kʼiḵlʼán ‘palate’ and waḵlʼandaa ‘around the eye’
kʼiḵlʼán	noun	palate (< kʼiḵ + lʼán)
waḵlʼandaa	noun	around the eye (< waaḵ ‘eye’ + lʼán + daa ‘around’)
√lʼatʼ	root	carry in tongs
lʼátʼaa	noun	tongs (< √lʼatʼ)
lʼál	noun	jackpine (cf. lʼél)
lʼaak	noun	dress
doonÿaax̱lʼaak	noun	petticoat (< doonÿaa ‘under clothes’ + lʼaak ‘dress’)
lʼákwti	noun	dry fallen tree
√lʼaḵ	root	put down hemlock branches for herring spawn
√lʼaḵw	root	stuck in muck (cf. lʼáaḵw, lʼáḵwti)
lʼáaḵw	noun	flat-bowed canoe (cf. √lʼaḵw, lʼáḵwti)
lʼáḵwti	noun	old and worn out thing (cf. √lʼaḵw, lʼáaḵw)
lʼáax̱ʼ	noun	greyish colour (in L78: 34; <?; cf. shalʼáax̱ʼ, lʼeix̱)
lʼáx̱ʼkw	noun	dirt (< tlʼáx̱ʼkw)
shalʼáax̱ʼ	noun	long beetle (in L78: 34; cf. lʼáax̱ʼ)
√lʼéi	root	promiscuous, sexually aroused
lʼé	noun	sediment (cf. lʼéiw)
takalʼeiÿí	noun	sediment in oil (< tá + ká + lʼé + -í)
lʼeiwú	noun	wood (cf. lʼé, lʼoowú)
lʼéiw	noun	sand (cf. √lʼéiw)
√lʼéiw	root	sandy (< lʼéiw)
lʼéinxw	noun	wool ear pendant
lʼénx̱i	noun	shabby (cf. tlʼénx̱i, lʼúx̱ʼti, √tlʼéin)
lʼél	noun	jackpine (cf. lʼál)
lʼeix̱	noun	aluminum, grey rock (cf. lʼáax̱ʼ)
√lʼex̱	root	dance
lʼeix̱	noun	dance (cf. √lʼex̱)
hinyiklʼéx̱i	water ouzel (< héen + ÿík + √lʼex̱ ‘dance’)
lʼax̱keit	noun	mask (< lʼeix̱ ‘dance’ + ká + át, see -keit)
alʼeix̱í	noun	dancer; sandhopper (< √lʼex̱)
lʼée	noun	potlatch blanket
ji.aax̱gwalʼí	noun	string for something on lix̱ʼooseit (in L78: 34)
lʼeet	noun	tail
lʼílʼ	noun	feces (cf. √lʼilʼ)
√lʼilʼ	root	defecate (cf. lʼílʼ)
√lʼik	root	pop louse or nit
kakalʼéek	noun	nit (< √lʼik)
√lʼik	root	wink (cf. √lʼixw, √lʼikw)
√lʼixw	root	close eyes (> √lʼux; cf. √lʼik, √lʼikw)
kadalʼíxwaa	noun	ice fog (<? ká + d- + √lʼixw + -áa)
√lʼikw	root	blink (> √lʼuk; cf. √lʼik, √lʼixw)
xeitllʼíkgu	noun	lightning (< xeitl + √lʼikw + -í)
√lʼixʼ	root	break 
lʼéexʼi	noun	broken piece (cf. √lʼixʼ)
√lʼux	root	close eyes (< √lʼixw)
√lʼuk	root	blink (< √lʼikw)
xeitllʼúkgu	noun	lightning (< xeitl + √lʼuk + -í)
√lʼuʼn	root	hunt
alʼóoni	noun	hunter (< √lʼuʼn)
lʼóoni	noun	hunt (< √lʼuʼn)
lʼóotʼ	noun	tongue
√lʼóotʼ	root	tongue (< lʼóotʼ)
√lʼutl	root	scavenge (cf. √lʼuʼn)
√lʼuk	root	snow have hard crust (in L78: 34)
lʼook	noun	coho salmon, silver salmon
√lʼuxʼ	root	gulp, drink up
√lʼux̱ʼ	root	spray milt, spawn; cloud water
lʼóox̱'	noun	milt
lʼúx̱ʼti	noun	worn (cf. lʼénx̱i, tlʼénx̱i, √tlʼéin)
tlʼa-	affix	in tlʼag̱áa ‘lots’ (cf. chʼa)
tlʼag̱áa	adv	lots (< tlʼa- unknown + -g̱áa ‘adessive’)
tlʼaa-	affix	in tlʼaadéin ‘crosswise’, maybe in tlʼaaḵʼwáchʼ ‘sorrel’
tlʼaadéin	adv	crosswise (< tlʼaa- unknown + -déin ‘adverb’)
eetlʼát	noun	lowbush cranberry (<? Dene)
tlʼátk	noun	earth, dirt, soil (cf. chʼáatwu, tlʼáx̱ʼkw, tlʼéx̱ʼkw, √chʼex̱ʼw)
tlʼáatlʼ	noun	yellow salmonberry; yellow thing (cf. chʼáalʼ, sʼáasʼ)
tlʼági	noun	bow of boat (in L78: 35)
√tlʼakʼ	root	wet
katlʼaakʼ	noun	mica (< √tlʼakʼ ‘wet’)
tlʼaaḵʼwáchʼ	noun	sorrel, wild rhubarb (cf. tlʼaa-, √ḵʼwach, √ḵʼwash)
tlʼáx̱ʼkw	noun	soil, earth (cf. tlʼéx̱ʼkw, tlʼátk, √chʼex̱ʼw)
atlx̱atlʼéi	interj	my goodness (in L73: 08/223)
√tlʼéin	root	pure, clean (with negation)
tlʼeitáḵw	noun	pure, honest, consecrated (< √tlʼéin + -áḵw ‘lacking’)
tlʼénx̱i	noun	shabby, messy (cf. lʼénx̱i, lʼúx̱ʼti, √tlʼéin, tlʼéxwti)
tlʼéinaa	noun	hair tie (< tlʼéenaa)
tlʼéinaa	noun	three-pronged stick for barbecuing salmon
√tlʼetʼ	root	grasp tightly, climb
kootlʼéitʼaa	noun	small white seagull (< √tlʼetʼ, cf. koochʼéitʼaa)
tlʼéili	noun	milt; fish guts
tlʼétlʼ	noun	moonfish, blowfish
tlʼéxwti	noun	ill-fitting, ugly (cf. tlʼénx̱i, lʼénx̱i, lʼúx̱ʼti)
√tlʼeʼkw	root	recoil, dodge, duck (cf. √sʼekw)
√tlʼekw	root	eat raw seafood
tlʼéx̱	noun	usnea
√tlʼeḵ	root	carry with pincers (< √tlʼiḵ)
tlʼeiḵw	noun	finger (< tlʼeeḵ)
tlʼéx̱ʼkw	noun	soil (cf. tlʼáx̱ʼkw, tlʼátk, √chʼex̱ʼw)
√tlʼin	root	tie up hair or cloth (cf. tlʼéenaa, tlʼéinaa, √chʼiʼn, chʼéen)
tlʼéenaa	noun	hair tie (< √tlʼin, cf. chʼéen)
shakatlʼéen	skein of yarn, hank of beads (< √tlʼin)
ḵʼalukatlʼéeni	noun	toebar
√tlʼit	root	throw away, discard
ḵutlʼídaa	noun	shovel (< √tlʼit)
√tlʼitʼ	root	fill with liquid (cf. √tsʼitʼ)
tlʼíl	noun	hammer; penis
√tlʼix	root	dirty, trashy (cf. tlʼeex)
tlʼeex	noun	trash (cf. √tlʼix, sʼeex ‘lint’)
tlʼixdaakeit	noun	trash can (< tlʼeex + daa + ká + át, see -keit)
√tlʼéekʼát	root	thread stick through to make rigid
tlʼéekʼát	noun	stick threaded through fish to make rigid for cooking
tlʼíkʼwx̱	noun	worm (cf. tlʼúkʼx̱)
√tlʼiḵ	root	carry with pincers (cf. tlʼeeḵ, tlʼeiḵ)
tlʼeeḵ	noun	finger (cf. tlʼeiḵ, wankachʼeeḵ)
√tlʼun	root	squint; mutter
tlʼóon	noun	big shot, self important
tlʼúkʼx̱	noun	worm (< tlʼíkʼwx̱)
aastutlʼúkʼx̱u	noun	woodworm
√tlʼuḵ	root	drip slowly
katlʼúḵjaa	noun	slow drip (< √tlʼuḵ)
tlʼoog̱ú	noun	liver (cf. √tlʼuḵ, tlʼoog̱ú)
tlʼóog̱u	noun	liver (cf. √tlʼuḵ, tlʼóog̱u)
√tlʼuʼḵ	root	rot and smell, develop sore (cf. tlʼooḵ)
tlʼooḵ	noun	open sore (cf. √tlʼuʼḵ)
sá	pcl	wh-question particle (cf. sí ‘dubitative’)
√saʰ	root	narrow, small in girth
√sa	root	breathe, rest (cf. daséikw, x̱ʼaséikw)
daséikw	noun	breath, air, life (< d- + √sa ‘breathe’ + -kw)
x̱ʼaséikw	noun	breath, air, life (< x̱ʼé ‘mouth’ + √sa ‘breathe’ + -kw)
√sa	root	name, call (cf. saa ‘name’)
saa	noun	name (cf. √sa ‘name, call’)
√saaÿí	root	famous (< saa ‘name’)
saaÿee	noun	calf of leg
dag̱asaa	noun	squid
saa	dirn	southern
Saanÿaa	name	Sanya ḵwáan (< saa ‘southern’ + niÿaa ‘direction’)
sáanáx̱	noun	south wind (< saa ‘southern’ + -náx̱ ‘through, along’)
sáanáx̱eit	noun	south wind (< sáanáx̱ + -eit)
√saʼÿ	root	hot, sweaty, steamy
kasáÿjaa	noun	heat (< √saʼÿ ‘hot, sweaty, steamy’)
√saʼn	root	cure shamanistically
sán	noun	waist in kasán ‘waist’ and sankeit ‘dance apron’
kasán	noun	waist (< ká + sán)
sankeit	noun	dance apron (< sán + ká + át, cf. -keit)
sáni	noun	father’s brother
sitgawsaan	noun	noon (< sitgamsaan < CJ sítkəm san ‘half day/sun’)
sitgansaan	noun	noon (< sitgamsaan < CJ sítkəm san ‘half day/sun’)
sitgamsaan	noun	noon (< CJ sítkəm san ‘half day/sun’)
sáani	noun	medium amount
=sáani	affix	plural of diminutive (< sáani ‘medium amount’)
kʼisáani	noun	boys, young men (< kʼi unknown + sáani)
shaaxʼsáani	noun	girls, young women (< sháa ‘woman’ + -xʼ ‘pl.’ + sáani)
woosáani	noun	hunting spear
sándi	noun	Sunday, week (< CJ sándi < Eng. Sunday)
sandix̱ʼáak	noun	week (< sándi + x̱ʼáak ‘interval’)
√sat	root	tight (cf. √hat ‘cover’, √sa ‘narrow’)
√sátkw	root	fast, quick (< √ha ‘move invisibly’)
sáaxdze	noun	orphaned bear cub, yearling rejected by mother (< Dene)
sáxwti	noun	handle (cf. síxwti)
sáaxw	noun	cockle
saak	noun	hooligan, eulachon
sáagi	noun	place for lying in wait
-sákw	adj	future, to be
kaságu	noun	beam of house (cf. kasúgu)
sagweit	noun	kind of deadfall trap (< sákw unknown + -eit; cf. seen)
sáxʼ	noun	edible cambium of spruce or hemlock
√saḵ	root	exhausted (cf. √shaḵ)
sáḵs	noun	yew; bow
√seʰ	root	near (cf. √leʰ ‘far, distant’)
sé	pcl	dubitative (< sí ‘dubitative’)
sé	noun	voice, neck
seit	noun	necklace (< sé + át)
saka.át	noun	necktie (< sé + ká + át)
sekawóot	noun	necklace (< sé + kawóot ‘bead’)
satú	noun	voice (< sé + tú)
sadaa	noun	neck (< sé + daa)
sadatʼaaÿ	noun	scarf (< sé + daa ‘around’ + tʼaaÿ ‘heat’)
sé	noun	place below or in front; cache
séixʼ	noun	in trade, in exchange (< sé ‘place below’ + -xʼ)
waḵdasé	noun	without seeing (< waaḵ ‘eye’ + daa ‘around’ + sé ‘place below’)
seiyí	noun	area below it; shelter (< sé ‘place below’ + -í)
séitaa	noun	snipe (< √set unknown or √sa unknown + -t)
√sel	root	bird sing, chirp
kaséix̱jaa	noun	soft rain (< kaséex̱jaa)
seig̱án	noun	tomorrow (<? √sa ‘breathe, rest’ + -án ‘restore’)
seig̱ánín	noun	 tomorrow (< seig̱án ‘tomorrow’ + -ín unknown)
√seḵʼw	root	stain, dye (cf. √lex̱ʼw ‘red’, léiḵʼw, léiḵʼw, shéix̱ʼw, shoox̱ʼ)
séiḵʼw	noun	dark spot, stain (cf. √seḵʼw)
kaséiḵʼw	noun	dye, color (< ká + √seḵʼw)
kaséḵʼx̱u	noun	dye, color (< ká + √seḵʼw + -x̱ + -í)
tukaséiḵʼu	noun	egg yolk (with kʼwátʼ; < tú + kaséiḵʼw)
sí	pcl	dubitative (> sé ‘dubitative’; cf. sá ‘wh-question’)
sée	noun	daughter; doll
síkʼ	noun	daughter (vocative; < sée + -kʼ ‘diminutive’)
jimasasée	noun	yellow warbler (< Dene)
séew	noun	rain (< séem)
séem	noun	rain
√séew	root	rainy (< séew ‘rain’)
kaséex̱jaa	noun	soft rain (<? séew ‘rain’)
√sin	root	hide, conceal
seen	noun	deadfall trap (cf. √sin ‘hide’, sein, sagweit)
sein	noun	deadfall trap (< seen)
sínk	noun	silk (< Eng.)
sánk	noun	silk (< Eng.)
√siʼt	root	braid
seet	noun	Sitka spruce canoe (cf. leet, √lit ‘slide’)
séet	noun	channel, portage
sítʼ	noun	glacier
√sis	root	tired, fatigued (cf. √siʼs)
√siʼs	root	lull to sleep (cf. √suʼs, √sis)
√suʼs	root	lull to sleep (cf. √siʼs)
ḵaasistʼaan	noun	spider (cf. ḵaashashx̱áaw ‘dragonfly’, √tʼan)
√sitsʼ	root	dripping wet
síxwti	noun	handle (cf. sáxwti)
√sik	root	put on belt (cf. séek ‘belt’)
séek	noun	belt (cf. √sik ‘put on belt’)
√siʼk	root	keep over, delay, detain
√sèek	root	bashful
√sik	root	have something wrong (only in L78: 37; <? Eng. sick)
kóonsík	noun	common cold (< CJ kólsik < Eng. cold sick)
√suʰ	root	supernatural help
sú	noun	long seaweed
sú	noun	ahead of
sóox̱	adv	ahead of, soon (< sú + -x̱)
súg̱aa	adv	for future (< sú + -g̱áa)
ÿeisú	adv	still, yet, just now (< ÿee ‘time’ + sú)
√suʼn	root	bubble; tipsy from drink
x̱ʼasúnjaa	noun	bubbles from fish (< x̱ʼé + súnjaa)
súnjaa	noun	bubble (< √suʼn)
√suʼs	root	pl. fall
√suʼs	root	lull to sleep (cf. √siʼs)
wasóos	noun	cattle (< waswóos < CJ musmús)
kasúgu	noun	beam of house (cf. kaságu)
sooḵ	noun	wide grass (cf. suḵtéitlʼ)
dzaaÿí	noun	thick hair of beard, whiskers, nose (cf. √dzaʼÿ)
√dzaʼÿ	root	grow beard (cf. dzaaÿí)
dzánti	noun	flounder
ḵʼaldzántí	noun	kind of flounder-like fish (in L73: 09/100; cf. dzánti)
yadzánlʼ	noun	lumpy, pock-marked face (<? dzán unknown + -lʼ)
dzáas	noun	leather thong (cf. dzaas, √dzas)
dzaas	noun	leather thong (cf. dzáas, √dzas)
√dzas	root	lace up (cf. dzáas, dzaas)
√dzas	root	winded, short of breath
dzeináa	noun	small snare (< dzeenáa)
dzeit	noun	ladder, stairs, bridge (<? √dza unknown + -eit ‘thing’)
tʼáadzeit	noun	sidewalk, boardwalk (< tʼáa ‘board’ + dzeit ‘ladder’)
dzagweit	noun	deadfall (< √dzakw unknown + -eit ‘thing’)
√dzée	root	difficult (cf. √dziʼÿ ‘balk’)
√dziʼÿ	root	balk, stop short, resist, retreat (cf. √dzée ‘difficult’)
ayaandzéeyi	noun	husky dog breed (< Ayáan + Dene dzí ‘dog’ + -í)
dzeenáa	noun	small snare (< √dzin unknown + -áa; cf. √dziʼÿ)
dzínx̱i	noun	kind of medicine (cited from Swanton in L78: 39)
√dziskw	root	call dog (only in L78: 39)
dzískʼw	noun	moose (also tsískʼw; cf. tsískʼw ‘owl’)
hinx̱ukadzéedzi	noun	sandpiper (< héen + x̱oo + ká + dzéets onomatopoiea?)
watsíx	noun	caribou (cf. wadzíx; < Dene cf. Tagish mesdzíh)
wadzíx	noun	caribou (cf. watsíx; < Dene cf. Tagish mesdzíh)
√dzixʼ	root	cover eyes (only in L78: 39)
√dzixʼw	root	crush clam to get juice (> √dzuxʼ; cf. dzéexʼw)
dzéexʼw	noun	small clam, butter clam (cf. dzóoxʼ, √dzixʼw)
√dzuxʼ	root	crush clam to get juice (< √dzixʼw; cf. dzóoxʼ)
dzóoxʼ	noun	small clam, butter clam (< dzéexʼw; cf. √dzuxʼ)
√dzuʰ	root	hit by throwing (cf. √dzuʼw, √dzéix̱aa, dzóonaa)
√dzuʼw	root	hit by throwing (cf. √dzuʰ, √dzéix̱aa, dzóonaa)
√dzéix̱aa	root	miss by throwing (< √dzuʰ + -x̱aa)
dzóonaa	noun	missile, thrown object (< √dzuʰ + -áa)
√dzus	root	skitter along surface (snow, rain, etc.; only in L78: 39)
dzúk	noun	back of person
tsaa	noun	seal (cf. √tsàa ‘belch’)
√tsàa	root	belch (< tsaa ‘seal’)
tsá	pcl	then (cf. tsáa, tsé)
tsáa	pcl	then (cf. tsá, tsé)
tsé	pcl	then (cf. tsá, tsáa)
√tsáaÿ	root	ask to accompany
tsálk	noun	groundsquirrel (cf. sʼaax̱)
√tsaʼtl	root	plastered (cf. katsáatl)
katsáatl	noun	plaster (cf. √tsaʼtl)
tsʼas	pcl	I wish (< tsaʼs <? tsaʼ + sí)
tsáats	noun	bear root, indian potato, Hedysarum alpinum (cf. tséitʼ)
√tsáakw	root	long-lasting, durable (cf. tlákw ‘always’)
tsáaxʼ	noun	gloves (<? Dene)
√tsaḵ	root	push, poke with long object (cf. tsaag̱álʼ, tsaag̱áa, wootsaag̱áa)
tsaag̱álʼ	noun	spear (< √tsaḵ + -álʼ)
tsaag̱áa	noun	spear (< √tsaḵ + -áa)
wootsaag̱áa	noun	cane, staff (< ÿa- + u- + √tsaḵ + -áa)
√tsaḵ	root	refuse, reject person (<? √tsaḵ ‘push, poke’)
tseiÿí	noun	sweetheart
tséitʼ	noun	plant with edible root (cf. tsáats)
√tsets	root	suffer, feel pain
tsín	noun	muskrat (<? Dene)
√tsin	root	living, moving; strong (negative stem –cheen)
latseen	noun	strength, power (< l- + √tsin)
shachklatseen	noun	Hudson Bay tea (< sháchk + latseen; cf. sʼikshaldéen)
lḵaatoolcheen	noun	kind of purple flower (< l + ḵaa + tu- + l- + √tsin)
yatseeneit	noun	bear, usually brown (< yatseen ‘living’ + -eit)
√tsis	root	float, be anchored; bob, swim surfacing intermittently
katsees	noun	buoy, fishing float (< √tsis)
katsistléiḵw	noun	watermelon (< katsees ‘buoy’ + tléiḵw ‘berry, fruit’)
√tsiʼts	root	simmer, nearly boil (only in L78: 40)
tsískʼw	noun	owl (also dzískʼw; cf. dzískʼw ‘moose’)
√tsik	root	roast on stick (cf. tséek)
tséek	noun	roasting stick (cf. √tsik)
√tsix̱	root	kick, move foot quickly (> √tsex̱)
√tsex̱	root	kick, move foot quickly (< √tsix̱)
√tsiʼx̱w	root	dam, block, obstruct (> √tsuʼx̱; cf. √tsix̱)
√tsuʼx̱	root	dam, block, obstruct (< √tsiʼx̱w; cf. √tsix̱)
√tsix̱ʼ	root	strangle (> √tsex̱ʼ; cf. √tsiʼx̱w)
√tsex̱ʼ	root	strangle (< √tsix̱ʼ; cf. √tsiʼx̱w)
√tsix̱ʼw	root	beads come off string (> √tsux̱ʼ)
√tsux̱ʼ	root	beads come off string (< √tsix̱ʼw)
tsú	pcl	also (cf. tsu)
tsóokʼ	adv	some more (< tsú + -kʼ ‘diminutive’)
tsu	pcl	again (cf. tsú)
√tsuʼw	root	push end of long thing forward; move household
katsóowaa	noun	dibble stick (< √tsʼuw ‘push end forward’)
tsóox̱	noun	corral (cf. √tsuʼx̱ ‘dam’)
sʼa-	noun	eyebrow in compounds (< sʼi- < sʼee)
√sʼa	root	claim thing to be destroyed (cf. sʼáayadi)
sʼáayadi	noun	something claimed as payment (< √sʼa + át + -í)
sʼáaw	noun	crab (< *sʼaʼm)
shalasʼáaw	noun	full grown deer horns (< shá + l- + sʼáaw)
sʼán	noun	wild carrot (< sʼín)
sʼaatí	noun	master, boss, expert (cf. √sʼaatí)
√sʼaatí	root	rule over, be master of (< sʼaatí)
√sʼáatʼ	root	left-handed (< sʼatʼ- ‘left’)
sʼátʼ-	dirn	left in sʼátʼnáx̱, no independent *sʼáatʼ (cf. √sʼáatʼ)
sʼátʼnáx̱	noun	left (< sʼátʼ- + -náx̱; cf. √sʼáatʼ)
sʼáasʼ	noun	goldfinch, canary; probably yellow warbler etc. (cf. √sʼasʼ)
sʼáasʼ	noun	waltz, dance (cf. √sʼasʼ)
√sʼasʼ	root	dance by sliding feet or swaying (cf. sʼáasʼ)
sʼaach	noun	shield fern (cf. gandaasʼaají ‘bee’)
gandaasʼaají	noun	bee (< gán ‘wood’ + daa ‘around’ +? sʼaach ‘fern’ + -í)
sʼáx	noun	starfish
sʼáxtʼ	noun	devilsclub
√sʼaxw	root	stack; put on hat (cf. sʼáaxw ‘hat’)
sʼáaxw	noun	hat (cf. √sʼaxw ‘stack’)
kanalsʼáak	noun	squirrel (< unknown √sʼak(w); cf. kalsʼáak)
kalsʼáak	noun	squirrel (< unknown √sʼak(w); cf. kanalsʼáak)
sʼaax̱	noun	groundhog, marmot (cf. tsálk)
sʼaaḵ	noun	bone (> √sʼàaḵ ‘bony’)
√sʼàaḵ	root	bony; ambitious (< sʼaaḵ ‘bone’)
sʼáax̱ʼ	noun	Pacific cod
sʼé	noun	clay; pottery, brick
sʼé	pcl	emphatic particle; semantics unclear (cf. sʼí)
sʼei	noun	eyebrow (cf. sʼee, sʼeeÿ)
naag̱asʼéi	noun	fox
√sʼelʼ	root	tear, rip, peel (cf. sʼéilʼ ‘wound’, sʼélʼ ‘rubber’)
sʼéilʼ	noun	wound (cf. √sʼelʼ ‘tear, rip’, sʼélʼ ‘rubber’)
sʼélʼ	noun	rubber (cf. √sʼelʼ ‘tear, rip’, sʼéilʼ ‘wound’)
lasʼéilʼi	noun	puller, ripper (< l- + √sʼelʼ)
√sʼekw	root	duck, dodge (cf. √tlʼeʼkw ‘recoil, dodge, duck’)
√sʼeḵ	root	suck (< √sʼiḵ ‘suck’)
√sʼeḵ	root	smoke (< √sʼiḵ ‘smoke’)
sʼeiḵ	noun	smoke (< sʼeeḵ)
kasʼeiḵ	noun	bark fibers, brown color (< ká + sʼeiḵ)
sʼéx̱	noun	bullpine, balsam fir, small hemlock on muskeg (< sʼíx̱)
sʼéix̱wani	noun	hanging lichen, Spanish moss etc. (cf. sʼéx̱, sʼéix̱ʼ)
√sʼex̱ʼ	root	gush; diarrhea (< √sʼex̱; cf. sʼéix̱ʼ)
sʼéix̱ʼ	noun	diarrhea (< sʼéex̱ʼ; cf. √sʼex̱ʼ)
sʼée	noun	salal
sʼee	noun	eyebrow (cf. sʼeeÿ, sʼei)
sʼeeÿ	noun	eyebrow (cf. sʼee, sʼei)
sʼiyitú	noun	corner of roof (< sʼee + ÿee + tú)
sʼín	noun	wild carrot (> sʼán)
√sʼin	root	grimace, flinch (cf. √xʼin ‘grimace, flinch’)
sʼeenáa	noun	lamp (< *√sʼin unknown + -áa)
√sʼit	root	wrap, screw, bind, bandage, braid
kasʼéet	noun	screw (< √sʼit ‘wrap, screw’)
choonkasʼéet	noun	payment for death (< choon + kasʼéet)
shakasʼídi	noun	calyx (cf. shakasʼéet ‘braided bun’, chʼéeni)
shakasʼéet	noun	braided bun of hair (< shá + ká + √sʼit ‘wrap’)
sʼéetʼ	noun	whale like killerwhale (in L78: 43 cited from Swanton)
√sʼis	root	blown by wind; sail; tire of something (cf. √chʼish ‘splash’)
sʼísaa	noun	sail; cloth (< √sʼis ‘blown by wind’)
√sʼísaa	root	sailing for pleasure (< sʼísaa ‘sail’ < √sʼis ‘blown by wind’)
kasʼéesjaa	noun	wind blowing things around (< ká + √sʼis + -ch + -áa)
√sʼisʼ	root	squirt water; instruct privately; whistle breathily
sʼeex	noun	lint (cf. tlʼeex ‘trash’, √sʼix ‘spoil’)
√sʼix	root	spoil, start to rot (cf. √sʼixw, sʼeex ‘lint’, √tlʼix, √tsʼix)
√sʼixw	root	sour (> √sʼux; cf. √sʼix ‘spoil’, √tlʼix ‘trashy’, √tsʼix)
sʼeek	noun	black bear
sʼíksh	noun	hellebore, skookum root (cf. sʼikshaldéen ‘Hudson Bay tea’)
√sʼikw	root	crisp, toast, fry (> √sʼuk)
sʼíxʼ	noun	dish (cf. sʼíxʼg̱aa ‘moss’)
sʼíxʼg̱aa	noun	moss (cf. sʼíxʼ ‘dish’)
tayisʼíxʼi	noun	saucer (< taÿee + sʼixʼ + -í)
sʼéexʼát	noun	shrimp (cf. xʼéesʼát ‘shrimp’, √xʼisʼ ‘tangled, matted’)
√sʼixʼw	root	adhere, stick
√sʼiḵ	root	suck (> √sʼeḵ)
√sʼiḵ	root	smoky (> √sʼeḵ; cf. sʼeeḵ ‘smoke’)
sʼeeḵ	noun	smoke (> sʼeiḵ; cf. √sʼiḵ ‘smoky’)
at.síḵsʼ	noun	smoking (< at- + √sʼiḵ ‘suck’ + -sʼ)
sʼiḵdaakeit	noun	tobacco pipe (< sʼeeḵ + daakeit)
sʼíx̱	noun	bullpine, balsam fir, small hemlock on muskeg (> sʼéx̱)
√sʼix̱ʼ	root	gush; diarrhea (> √sʼex̱ʼ; cf. sʼéex̱ʼ)
sʼéex̱ʼ	noun	diarrhea (> sʼéix̱ʼ; cf. √sʼix̱ʼ)
kasʼíx̱ʼaa	noun	hose (< √sʼix̱ʼ + -áa)
sʼú	noun	thin branch or root (cf. √sʼu)
√sʼu	root	limber root or branch by twisting (cf. sʼú)
sʼoow	noun	greenstone, jade (< *sʼuʰm; cf. √sʼuʼw)
√sʼuʼw	root	chop (cf. sʼoow ‘greenstone’)
kasʼúwaa	noun	chopper (< ká + √sʼuʼw + -áa)
sʼaḵsʼúwaa	noun	bone chopper (< sʼaaḵ ‘bone’ + √sʼuʼw + -áa)
√sʼuʼn	root	squint (cf. √tsʼuʼn)
√sʼuʼn	root	make kissing noise
sʼúdi	noun	lower foreleg
√sʼutʼ	root	spit (cf. √tsʼuʼt ‘close tightly, pucker’)
sʼúsʼ	noun	harlequin duck
√sʼusʼ	root	thread on stick for drying (cf. sʼóosʼ)
sʼóosʼ	noun	stick for drying (cf. sʼóosʼ)
sʼóosʼani	noun	pinecone (< √sʼusʼ; cf. sʼóosʼ)
√sʼóoshkw	root	pinch flesh
sʼook	noun	barnacle
√sʼux	root	sour (< √sʼixw)
√sʼuk	root	crisp, toast, fry (< √sʼikw)
sʼóoxʼ	noun	blocking; in waḵkasʼóoxʼ, jikasʼóoxʼ (cf. chʼóokʼ)
waḵkasʼóoxʼ	noun	blocking view (< waaḵ ‘eye’ + sʼóoxʼ ‘blocking’)
jikasʼóoxʼ	noun	blocking reach (< jín ‘hand’ + ká + sʼóoxʼ ‘blocking’)
sʼóoḵ	noun	rib
sʼuḵkasdúk	noun	solid-ribbed brown bear (< sʼooḵ ‘rib’ + kasdúk unknown)
gisʼóoḵ	noun	aurora, northern lights
√sʼux̱	root	move slightly, budge, dislocate (cf. √tsʼux̱)
√sʼux̱ʼ	root	dried mucus (with waḵ- ‘eye’ + ka- + l-)
tsʼa	pcl	just (var. of chʼa)
√tsʼáa	root	smell good
√tsʼan	root	shallow (cf. √dlan ‘deep’)
√tsʼal	root	drip
tsʼas	pcl	just, only (< tsʼa + sí; cf. chʼas)
atsʼáts	noun	osprey, fishhawk, seahawk
kaneiltsʼákw	noun	black currant
tsʼáḵl	noun	black paint, ink
√tsʼeʼn	root	cease; leave alone
lyax̱datsʼéini	noun	trickster (< √tsʼeʼn ‘cease, leave alone’)
√tsʼetʼ	root	cut carefully, flay, flense
tsʼésx̱ʼw	noun	snail; whelk (< tsʼísx̱w; cf. tlʼélx̱ʼw)
√tsʼex̱	root	crave, have predilection for, indulge (cf. tsʼéix̱i)
tsʼéix̱i	noun	addict (cf. √tsʼex̱)
tsʼatsʼée	noun	songbird (cf. tsʼítskw)
kutsʼeen	noun	rat
tsʼéendli	noun	forearm
√tsʼitʼ	root	full of liquid; heavily loaded boat (cf. √tlʼitʼ)
√tsʼísxwaa	root	sneeze (cf. √tsʼísaa, √tsʼíxaa)
√tsʼísaa	root	sneeze (cf. √tsʼísxwaa, √tsʼíxaa)
√tsʼíxaa	root	sneeze (cf. √tsʼísxwaa, √tsʼísaa)
tsʼítskw	noun	songbird (cf. tsʼatsʼée)
√tsʼix	root	damp, rotten (cf. √sʼix ‘spoil’, √sʼixw ‘sour’, √tlʼix)
√tsʼik	root	whine, fuss, tantrum
tsʼíktsʼík	noun	wagon, cart, car (< CJ tsʼíktsʼik)
tsʼéekáx̱kʼw	noun	mountain blueberry, jacobberry
√tsʼikʼ	root	pinch (cf. √tsʼikʼw, √tsʼígwaa)
√tsʼikʼw	root	pinch (cf. √tsʼikʼ, √tsʼígwaa, tsʼéekʼu, tsʼíkʼwti)
√tsʼígwaa	root	delicate, touchy issue (cf. √tsʼikʼ, √tsʼikʼw)
tsʼéekʼu	noun	‘button’ of shell; umbo?, operculum? (cf. √tsʼikʼw)
tsʼíkʼwti	noun	‘button’ of shell; umbo?, operculum? (cf. √tsʼikʼw)
tsʼu	pcl	even, just, the same (cf. chʼu)
√tsʼuʼn	root	squint, look through nearly closed eyes (cf. √sʼuʼn, √tlʼun)
√tsʼuʼt	root	close tightly, pucker (cf. √sʼutʼ ‘spit’)
√tsʼutsʼ	root	fish nibble, jerk on line
tsʼóotsʼ	noun	fishing expert, fish feeler (cf. √tsʼutsʼ)
√tsʼux̱	root	move slightly, budge, dislocate (cf. √sʼux̱)
shá	noun	head (cf. sháan, sháak)
shanáa	noun	over head (< shá + náa ‘draped over’)
sháan	noun	inside of head (cf. shá, sháak)
sháak	noun	head of river or lake
shakée	noun	above, top (< shá ‘head’ + kée ‘up’)
shakee.át	noun	frontlet hat (< shakée + át)
shantú	noun	upstairs, attic (< sháan + tú)
-dasháan	affix	headed in direction, adverbial affix (cf. shá ‘head’)
√shaʰ	root	bark (dog; cf. tsaa ‘seal’)
√sha	root	marry (> √sháaÿ ‘marry each other’, √sháaxʼw; cf. sháa ‘woman’)
√sháaÿ	root	marry each other (< √sha ‘marry’)
√sháaxʼw	root	get wife (< √sha ‘marry’ + -xʼ)
sháaʷ	noun	woman (cf. √sha ‘marry’, √sháaÿ, shaawát ‘girl, woman’, shátx̱)
sháawu	noun	clan sister
shát	noun	wife (cf. sháa ‘woman’, √sha ‘marry’, √sháaÿ)
shaatkʼ	noun	young woman, girl (< shaawát + -kʼ)
taḵsháa	noun	widow (< taḵ unknown + sháa)
asgutuyiksháa	noun	beetle, spider (< aasgutú + ÿík + sháa)
tuyiksháa	noun	junebug (< tú + ÿík + sháa)
shaa	noun	mountain
shaaw	noun	gumboot, chiton
√shan	root	old, gray (cf. shaan ‘old age’)
shaan	noun	old age (> shaan ‘old, elderly’; cf. √shan ‘old, gray’)
shaan	adj	old, elderly (< shaan ‘old age’)
eesháan	interj	too bad, poor, sad (< eesháan ‘poverty’)
eesháan	noun	poverty (> √.eesháan ‘poor’; cf. shaan ‘old age’, √shan ‘old’)
√.eesháan	root	poor, pitiable (< eesháan ‘poverty’)
Sháanséet	name	Craig
√shaʼt	root	grab, catch, capture, hold
shádaa	noun	funnel (< √shaʼt + -áa)
g̱alsháatadi	noun	captive (< √shaʼt ‘grab, capture’ + át ‘thing’)
aashát	noun	steelhead
shaadí	noun	sprout
shátx̱	noun	older sister of woman (cf. sháa ‘woman’, shát ‘wife’)
shál	noun	spoon
leineitshál	noun	horn spoon (< leineit + shál)
yetsʼshál	noun	black horn spoon (< yétsʼ + shál)
sháal	noun	funnel-shaped fish trap (cf. chaal)
√sháash	root	wear out
sháchk	noun	muskeg, swamp
√sháchk	root	swampy (< sháchk ‘muskeg’)
sháachʼ	noun	young herring
sháachʼ	noun	kind of epiphyte and cliff plant
asxʼaansháachʼi	noun	creeper bird (< aas + xʼaan + sháachʼ + -í)
sháak	noun	timothy grass
shákw	noun	strawberry (cf. shíkw, shúk)
shaaḵ 	noun	driftwood, snag, drift log
shaḵyátxʼi	noun	small pieces of driftwood in Raven story (< shaaḵ + ÿát)
shaax̱	noun	gray currant
waḵshaax̱	noun	gray-eyed person or animal (< waaḵ + shaax̱)
√shaḵ	root	exhaust, breathless, hunt to exhaustion (cf. √saḵ)
√sháaḵ	root	deny (with irrealis u-)
sháḵʼw	noun	mythical wolf-like animal; variety of dog (> shúḵʼ)
shé	interj	surprise; in haashé, dáa shé
shé	noun	blood (cf. shí, sheiÿí, sheeÿí)
sheiÿí	noun	blood (cf. shé, shí, sheeÿí)
-shé	affix	in gushé ~ kwshé ‘maybe’ (< -shí)
gushéilʼ	interj	I don’t know, irritated (< gushí ‘maybe’ + -lʼ unknown)
shéiÿi	noun	Sitka spruce (cf. shée, shéeÿi)
-sheit	affix	thing (< -sh + -eit)
sheixw	noun	close-quarters bow and arrow (< sheexw)
shéix̱ʼw	noun	red alder (cf. √lex̱ʼw, √sex̱ʼw, léix̱ʼw, léiḵʼw, shoox̱ʼ)
-shí	affix	in gushí ~ kwshí ‘maybe’ (> -shé)
√shiʰ	root	sing (cf. shí ‘song’, atshí ‘song, music’, atsheeÿí ‘singer’)
shí	noun	song (cf. √shiʰ ‘sing’)
atshí	noun	song, music (< √shiʰ ‘sing’; cf. shí ‘song’)
atsheeÿí	noun	singer (< √shiʰ ‘sing’)
atshiḵóok	noun	radio, record player, CD player (< atshí + ḵóok ‘box’)
shée	interj	calling attention; in shéeshée ‘hey’, akshéedé ‘hey you’
shée	noun	Sitka spruce (cf. shéiÿi, shéeÿi)
Shée	name	Baranof Island (said to be from shée ‘Sitka spruce’)
Shéey	name	Baranof Island (said to be from shéeyi ‘Sitka spruce’)
√shiʰ	root	reach, touch; search; help; caress, stroke (cf. sheeÿ)
√shi	root	hope
sheeÿ	noun	right hand (cf. shiÿnáx̱, sheenáx̱, √shiʰ ‘reach’)
shiÿnáx̱	noun	right (< sheeÿ + -náx̱; > sheenáx̱; cf. √shiʰ ‘reach’)
sheenáx̱	noun	right (< shiÿnáx̱; cf. √shiʰ ‘reach’)
sheeÿ	noun	limb; knot in wood
shéeÿi	noun	Sitka spruce (cf. shée, shéiÿi)
shéeÿuwáa	noun	Douglas fir (< shéeÿi ‘Sitka spruce’ + uwáa)
shéen	noun	bailer, large spoon
washéen	noun	machine, engine (< Eng. machine; via CJ?)
mashéen	noun	machine, engine (< Eng. machine; via CJ?)
√shitʼ	root	crowd, shove, pack tight
√shisʼ	root	squeeze out (cf. √shéesht)
√shísʼḵ	root	raw, uncooked (< shísʼḵ)
shísʼḵ	noun	raw flesh, uncooked food (< √shisʼ ‘squeeze out’ + -ḵ ‘lacking’)
√shéesh	root	outdo at feast
√shéesht	root	correct mistake nicely (<? √shéesh + -t)
√shéesht	root	squeeze out (cf. √shisʼ)
shéesht	noun	lucky gambling stick
keishísh	noun	beach alder
√shish	root	sip
sʼelasheesh	noun	flathead duck (< √shish)
sheesh	noun	inconnue
shéech	adj	female
√shéech	root	effeminate (< shéech ‘female’)
sheexw	noun	close-quarters bow and arrow (> sheixw, shoox)
sheexú	noun	spleen
shíkw	noun	strawberry (> shúk; cf. shákw)
tayashágu	small red sea anemone (< té + ÿá + shákw + -í)
√shikʼw	root	cramp, shock; blather, talk too much (> √shukʼ, kashéekʼw)
kashéekʼw	noun	cramps, electricity (< √shikʼw; > kashóokʼ)
√shix̱ʼ	root	praise (> kashéex̱ʼ)
kashéex̱ʼ	noun	praise, glory (< √shix̱ʼ)
√shu	root	end, extend, hang (cf. shú, shoowú)
shú	noun	end (cf. √shu, shoowú)
shuká	noun	crest (< shú + ká)
shkwá	noun	crest (< shuká)
shuwee	noun	below, before (< shú + ÿee)
ÿanshuká	noun	campsite, wilderness (< ÿán + shú + ká)
shoowú	noun	part (cf. shú, √shu)
-dooshú	affix	in numerals (< át wooshóo ‘ending there at it’)
nashoowú	noun	clan relative (< naa + shoowú)
√shuʰ	root	strongly affected, intoxicated, drunk
kanashú	noun	drunkenness (< √shuʰ ‘drunk’)
gishoo	noun	pig (< CJ koshó < Fr. le cochon)
kʼinashóo	noun	pneumonia
shóosʼi	noun	tobacco smoking; in shóosʼi hídi tobacco house (cf. √sʼusʼ)
√shuch	root	bathe, sit in cold water
daadashooch	noun	bathing (< √shuch ‘bathe’)
shúk	noun	strawberry (< shíkw; cf. shákw)
shóogaa	noun	sugar (< CJ shúga < Eng. sugar)
shóogu	noun	same, initial (with chʼu)
shoox	noun	close-quarters bow and arrow (< sheexw)
sheishóox̱	noun	rattle (<? C.Tsim.)
√shuḵ	root	laugh, smile, funny
atshóoḵ	noun	laughter (< √shuḵ)
shúḵʼ	noun	mythical wolf-like animal (< sháḵʼw)
shoox̱ʼ	noun	robin (cf. √lex̱ʼw, √sex̱ʼw, léix̱ʼw, léiḵʼw, shéix̱ʼw)
shoox̱ʼuwáa	noun	varied thrush (< shoox̱ʼ ‘robin’ + uwáa)
jáʼ	interj	honey, addressing spouse
√jaʰ	root	advise, instruct, direct
jánwu	noun	mountain goat (< ján unknown + -wu < √wu ‘pale’)
gukkajaash	noun	earring (< gúk + ká + jaash unknown)
jáaji	noun	snowshoe
√jaḵ	root	kill (cf. √jáaḵw, jáḵwti ‘corpse’, jaḵtawteetʼí ‘murderer’)
jaaḵ	noun	corpse, murder victim (cf. √jaḵ, jáḵwti)
√jaḵw	root	settle, get in place; tidy; skillful
kaajáḵw	noun	adept (< √jaḵw ‘skillful’)
√jáaḵw	root	beat up (<? √jaḵ ‘kill’; cf. jáḵwti)
jáḵwti	noun	corpse, murder victim (cf. √jáaḵw, √jaḵ)
jáag̱oo	adv	in chʼa jáag̱oo ‘long ago, once upon a time’ (in L73: 10/135)
-jeit	affix	thing (< -ch + -eit)
√jel	root	grope, move hands; carry load
√jeʼtl	root	spread apart
waḵjéitl	noun	baggy eyes (< waaḵ ‘eye’ + √jeʼtl ‘spread apart’)
√jech	root	surprise, astonish, amaze (cf. √dlekw)
√jech	root	weigh down
jéigít	noun	jacket (< Eng. jacket)
√jiʰ	root	think, suppose; wonder, curious
√jèe	root	punish
√jée	root	awful, terrible; ugly, gross, nasty
√jiʼÿ	root	walk with long exaggerated steps (only in L78: 48)
ji-	affix	incorporated and compounding form of jín ‘hand’
jikag̱ayéisʼ	noun	handcuffs (< jín ‘hand’ + ká + g̱ayéisʼ ‘iron’)
jee	noun	possession (cf. jín ‘hand’, keijín ‘five’)
jín	noun	hand, arm (cf. jee ‘possession’, keijín ‘five’)
√jín	root	have hand, arm (< jín ‘hand, arm’)
l.uljíni	noun	vest, lit. ‘armless’ (< √jín ‘have arm’)
keijín	num	five (< kéi ‘up’ + jín ‘hand’)
jís	ppn	for possession (< jee ‘possession’ + ÿís ‘for’)
√jixw	root	spin, roll on axis (> √jux)
koojíxwaa	noun	wheel, wheelbarrow (< √jixw + -áa)
√jikʼ	root	carry over shoulder
Jeeshḵweidí	name	clan name (< jeesh-ḵú + -eit + -í)
√jiḵ	root	scale fish (> √jeḵ; cf. kajeeg̱í ‘scales’)
jeeg̱í	noun	kidney of fish
kajeeg̱í	noun	scales of fish (> kajeig̱í; cf. √jiḵ ‘scale fish’)
jig̱ei	noun	crook of arm, embrace (< jín + g̱ei)
jikóol	noun	back of hand (< jín + kóol)
√jix̱ʼw	root	sling, fling (> √jux̱ʼ)
jíx̱ʼwaa	noun	sling (< √jix̱ʼw)
√jeḵ	root	scale fish (< √jiḵ; cf. kajeig̱í ‘scales’)
kajeig̱í	noun	scales of fish (< kajeeg̱í; cf. √jeḵ ‘scale fish’)
√juʼw	root	dissheveled, messy
√jun	root	dream (cf. joon)
joon	noun	dream (cf. √jun)
junḵóoxʼ	adv	in dreams (< joon ‘dream’ + ḵú ‘areal’ + -xʼ ‘loc.’)
júk	interj	get, scat, scram, go away (cf. chúk)
gijook	noun	golden eagle, mountain hawk
√jux	root	spin, roll on axis (< √jixw)
koojúxaa	noun	wheel, wheelbarrow (< √jux + -áa)
júḵk	noun	robin (cf. shoox̱ʼ)
√jux̱ʼ	root	sling, fling (< √jix̱ʼw)
júx̱ʼaa	noun	sling (< √jux̱ʼ)
cha	interj	interrupting other speaker
√cha	root	strain (cf. √dla ‘sediment settle’)
chaa	noun	in-law, opposite clan by marriage (cf. chaaḵáa, cháa, chaan)
chaaḵáa	noun	in-law, opposite clan by marriage (< chaa + ḵáa)
cháa	adv	well spoken in tléil cháa x̱ʼeishtí ‘he’s crabby’ (cf. chaa)
kacháwli	noun	sweetheart (cf. √chul, kanalchóolani ‘mistress’)
√chán	root	stinky (< chán ‘stench, stink’)
√chánx̱aa	root	pretend, imagine stink (< √chán + -x̱aa)
chán	noun	stench, stink
kalchaneit	noun	mountain ash (< ká + l- + √chán + -eit)
ḵáakʼwchán	noun	baby boy (< ḵáa ‘man’ + -kʼ ‘dim.’ + chán ‘stink’)
shawatkʼichán	noun	baby girl (< shaawát ‘girl’ + -kʼ ‘dim.’ + chán ‘stink’)
dachx̱án	noun	grandchild (cf. x̱án ‘near’, chán ‘stench’)
chx̱ánkʼ	interj	grandkid, addressing grandchild (< dachx̱án + -kʼ ‘dim.’)
chaan	noun	mother in law (cf. chaa)
chaadí	noun	section above tail of bird, especially Raven
chál	noun	platform cache (cf. chíl)
chalxóok	noun	air-dried salmon (< chál + √xuk)
teetx̱ʼachálx̱i	noun	sponge (< teet + x̱ʼé + √chal unknown; cf. hinx̱ʼachálx̱i)
hinx̱ʼachálx̱i	noun	sponge (< héen + x̱ʼé + √chal unknown; cf. teetx̱ʼachálx̱i)
chaal	noun	square fish trap (cf. sháal)
cháatl	noun	halibut
√chalʼ	root	tired after eating, indulging, food coma
cháasʼ	noun	humpy salmon, pink salmon
cháash	noun	bough, limb of tree with foliage; brush, logging slash
chashhít	noun	temporary brush house (< cháash + hít)
cháashga	noun	teacup (< Ru. чашка)
√chaʼk	noun	pack, put away neatly; stack, pile up; pass away (euph.)
chág̱ayi	noun	antler (< cháḵ unknown + -aa + -í)
cháax̱	noun	grebe
kʼinchéiÿi	noun	rose hips
chéin	noun	chain (< Eng. chain)
√chetl	root	thaw, melt off
√chech	root	walk spread-legged
√chech	root	dust, clean surface
chéix̱ʼ	noun	shadow, shade (< chéex̱ʼ)
chéx̱ʼ	noun	shadow, shade (< chéix̱ʼ)
√chex̱ʼ	noun	shadow move (< √chix̱ʼ; cf. chéix̱ʼ, chéx̱ʼ)
chée	noun	kind of bird, marbled guillemot (in L37: 10/201)
chíl	noun	platform cache (cf. chál)
chilxóok	noun	air-dried salmon (< chíl + √xuk)
√chish	root	obtain easily
gunalchéesh	interj	thank you (< hél gunalchéesh < √chish ‘obtain easily’)
cheech	noun	porpoise
chichuwáa	noun	porpoise-like shark (< cheech + uwáa)
chichwú	noun	beluga (< cheech ‘porpoise’ + √wu ‘pale’)
√chígaa	root	fierce (< √chik unknown + -áa)
chíg̱ayi	noun	hoof, forefoot (<? √chiḵ unknown + -aa + -í)
chéex̱ʼ	noun	shadow, shade (> chéix̱ʼ, chíx̱ʼ; cf. √chix̱ʼ)
chíx̱ʼ	noun	shadow, shade (< chéex̱ʼ; cf. √chix̱ʼ)
√chix̱ʼ	root	shadow move (> √chex̱ʼ; cf. chéex̱ʼ, chíx̱ʼ)
dachóon	dirn	straight towards, forward (cf. √chuʼn, chooneit)
√chuʼn	root	wounded (cf. dachóon, choon, chooneit, √chuʼn ‘twist to split’)
choon	noun	wound (cf. √chuʼn, chooneit)
chooneit	noun	arrow (< *chuʰn ‘arrow’ + -eit; cf. √chuʼn)
kindachooneit	noun	mallard (< kín + -dé + chooneit; cf. chʼax̱ʼínx̱ʼ)
chugwéil	noun	bag for arrowheads (< *chuʰn + gwéil; cf. chooneit)
√chuʼn	root	twist to split (cf. √chuʼn ‘wound’)
√chul	root	munch, roll around in mouth (cf. kanalchóolani)
kanalchóolani	noun	mistress (cf. √chul ‘munch’, kacháwli ‘sweetheart’)
chush	pron	self, reflexive possessor
√chux	root	rub, massage, knead, pat (cf. √chuʼk, √chuxʼ, kachóox)
kachóox	noun	clay shaped with hands (cf. √chux ‘rub, massage, knead’)
chookán	noun	grass
√chuʼk	root	rub to soften (cf. √chux, √chuxʼ)
√chuxʼ	root	graze, touch or shake lightly (cf. √chux, √chuʼk)
√chux̱	root	cadge, sponge off someone (with irrealis u-)
√chux̱ʼ	root	fat? roll off (cf. leikachóox̱ʼu, √chóox̱ʼálʼ)
√chóox̱ʼálʼ	root	shake, manhandle, push roughly (< √chux̱ʼ + -álʼ)
leikachóox̱ʼu	noun	trachea (< lé ‘throat’ + ká + √chux̱ʼ ‘roll’ + -í)
chʼa	pcl	just (cf. chʼu)
chʼas	pcl	just, only (< chʼa + sí)
chʼaan.eex̱í	noun	oil on wet ground (< chʼaan unknown + eex̱ ‘oil’ + í)
chʼáatwu	noun	epidermis (< chʼáat unknown + √wú ‘pale’; cf. tlʼátk)
√chʼalʼ	root	pale, spotted (cf. √chʼachʼ, chʼáalʼ ‘willow’, √gaxʼ, √kaxʼ)
chʼáalʼ	noun	willow; pale (cf. √chʼalʼ ‘pale, spotted’)
√chʼachʼ	root	spotted, polka-dotted (cf. √chʼalʼ, √gaxʼ, √kaxʼ)
chʼáagu	adv	long ago (< chʼa + *tláagu; cf. jáag̱oo, tlákw, tlaagú, tlágu)
chʼáakʼ	noun	bald eagle
chʼakʼyéisʼ	noun	juvenile bald eagle (< chʼáakʼ + yéisʼ)
√chʼakʼw	root	carve, incise (cf. kachʼákʼwaa)
kachʼákʼwaa	noun	carving knife, chisel (< ká + √chʼakʼw + -áa)
chʼákʼwaa	noun	hole-making tool for wood (< √chʼakʼw + -áa)
chʼáakʼu	noun	in iḵtáanáx̱ chʼáakʼu ‘holes for snowshoe footfill’
atkachʼáakʼu	noun	wood carver (< √chʼakʼw)
chʼéiyi	noun	in kʼichʼéiyi ‘gizzard, crop of bird’
kʼichʼéiÿi	noun	gizzard, crop (< kʼí ‘base’ + chʼéiyi unknown)
kʼishantuchʼéiyi	noun	gizzard, crop (< kʼí + shantú + chʼéiyi)
koochʼéitʼaa	noun	ball (< koochʼéetʼaa)
wankachʼeiḵ	noun	little finger (< wankachʼeeḵ)
chʼéix̱ʼi	noun	index finger, pointer (< chʼéex̱ʼi)
√chʼex̱ʼ	root	point, poke (< √chʼix̱ʼ)
chʼeix̱ʼ	noun	thimbleberry (< chʼeex̱ʼ)
√chʼex̱ʼw	root	dirty; tiresome food (cf. chʼéix̱ʼw, tlʼáx̱ʼkw)
chʼéix̱ʼw	noun	dirt, smut (cf. √chʼex̱ʼw, tlʼáx̱ʼkw, tlʼátk)
x̱akwtayeechʼéix̱ʼw	noun	fingernail dirt (< x̱ákw + tá + ÿee + chʼéix̱ʼw)
luchʼéix̱ʼw	noun	dirty nose (< lú + chʼéix̱ʼw)
√chʼéix̱ʼu	root	dirty (< chʼéix̱ʼw ‘dirt’)
√chʼéeÿáḵw	root	slow (< √chʼi unknown + -áḵw ‘lacking’)
√chʼiʼn	root	tie up hair (cf. chʼéen, √tlʼin)
chʼéen	noun	hair ribbon (cf. √chʼiʼn, √tlʼin, tlʼéenaa)
chʼéeni	noun	calyx and stem of berry (< chʼéen, shakasʼídi)
ḵʼaluchʼéeni	noun	philtrum (< ḵʼa- ‘mouth’ + lú ‘nose’ + chʼéen ‘ribbon’)
lakʼichʼchʼéeni	noun	merganser crest, ponytail  (< lakʼíchʼ + chʼéen)
chʼeet	noun	auklet or murrelet
chʼeetg̱áa	noun	skate (<? chʼeet + -g̱áa)
ḵʼeichʼeedí	noun	packrat (<? ḵʼa- + chʼeet + -í)
tachʼeedí	noun	suckerfish (<? té or tá + chʼeet + -í)
chʼéedaadáa	interj	 songbird call (cf. tsʼatsʼée)
√chʼitʼ	root	lick from finger or stick
tuḵx̱ʼachʼítʼaa	noun	stick for wiping anus (< tooḵ + x̱ʼé + √chʼitʼ + -áa)
koochʼéetʼaa	noun	ball (< √chʼitʼ unknown)
√chʼéetʼaa	root	play ball (< koochʼéetʼaa)
√chʼish	root	splash (cf. √sʼis ‘blown by wind’)
lakwchʼísh	noun	common scoter (< lakw unknown + √chʼish ‘splash’)
wankachʼeeḵ	noun	little finger (< wán + ká + chʼeeḵ < tlʼeeḵ ‘finger’)
chʼéex̱ʼi	noun	index finger, pointer (< √chʼix̱ʼ; > chʼéix̱ʼi)
√chʼix̱ʼ	root	poke, point (> chʼéex̱ʼi, √chʼex̱ʼ)
chʼeex̱ʼ	noun	thimbleberry (> chʼeex̱ʼ)
chʼu	pcl	even, just, still, the same (cf. chʼa, tsʼu)
kʼichʼóo	noun	gambling game, perhaps with chair dice (also gichʼóo)
chʼuljíni	noun	vest (< chʼu + l.uljíni)
chʼóotʼ	noun	clitoris
chʼóokʼ	noun	outside edge in waḵchʼóokʼ, ganchʼóokʼ (cf. sʼóoxʼ)
waḵchʼóokʼ	noun	corner of eye (< waaḵ ‘eye’ + chʼóokʼ ‘outside edge’)
ganchʼóokʼ	noun	by fire (< gán ‘firewood’ + chʼóokʼ ‘outside edge’)
chʼúḵlʼ	noun	surf smelt; sand lance
√xa	root	pour
xán	noun	baleen; plastic (> xén)
Tsʼootsxán	name	Tsimshian (< *tsʼumtsxan < C.Tsim. *tsʼəmtsxan)
xáanaa	noun	evening (cf. xee ‘dusk’)
√xaʼt	root	pull, tighten; fasten, extend; shape, resemble (cf. √xwasʼ)
xaadáa	noun	veil; netting, cheesecloth (< √xaʼt + -áa)
√xatʼ	root	pull with rope, drag; suspend
xátʼaa	noun	sled (< √xatʼ + -áa)
yuwashuxáatʼi	noun	apron (< yoow + ÿá + shú + √xatʼ + -í)
xáatl	noun	iceberg
xaas	noun	wood bison; cattle, oxen
xaasyádi	noun	donkey (< xaas + ÿát + -í)
xaasdugutéel	noun	leather shoes (< xaas + doogú + téel)
√xasʼ	root	scrape, slime fish (cf. xáasʼ ‘fish skin’)
xáasʼ	noun	fish skin
xáasʼ	noun	clear sky (< xáatsʼ)
xáatsʼ	noun	clear sky (> xáasʼ; cf. √xatsʼ)
√xatsʼ	root	sky become clear (cf. xáatsʼ ‘clear sky’)
√xash	root	cut, saw (cf. xáshaa, atxáshti)
xáshaa	noun	saw (< √xash + -áa)
atxáshti	noun	cut leather (< √xash ‘cut, saw’)
√xach	root	despair of, give up on
√xak	root	bare of flesh, dessicated; dry weather (cf. xáak, ḵuxaak, √xuk)
xáak	noun	empty shell of mollusk, mollusc (cf. √xak ‘bare of flesh’)
ḵuxaak	noun	dry weather (< ḵu- + √xak)
√xáak	root	fragrant
√xakw	root	grind, whip up (cf. kaxágwaa ‘pestle’, xákwlʼi ‘soapberry’)
kaxágwaa	noun	pestle (< ká + √xakw + -áa)
xákwlʼi	noun	soapberry (< √xakw + -lʼ + -í)
xákw	noun	sandbar (<? √xakw ‘grind, whip up’, √xak ‘dessicated’)
tudaxákw	noun	basket with rattle in lid (<? √xakw ‘grind’, √xak ‘dry’)
shakaxaagú	noun	skull (< shá + ká + √xak + -í)
xei	noun	dusk (< xee)
xeiÿí	noun	mountain shadow (< xeeÿí)
√xeʼn	root	scab; white fungus on fish (cf. xein)
xein	noun	old dying salmon (cf. √xeʼn)
xén	noun	baleen; plastic (< xán)
naaxein	noun	Chilkat blanket
√xeʼt	root	wind knocked out (cf. xeitká ‘sternum, chest’)
xeitká	noun	sternum, chest
xéidu	noun	comb
xeitl	noun	thunderbird, thunder
xeitldáasʼayi	noun	rainbow (< xeitl + dáasʼaa)
xeitlteyí	noun	puffball (< xeitl + té + -í)
xeitltáaxʼayi	noun	horsefly (< xeitl + táaxʼaa)
√xes	root	catch bird with box trap
xeisáa	noun	bird trap (< √xes + -áa)
√xekʼw	root	draw in fluid and air, slurp
xee	noun	dusk (> xee)
xeeÿí	noun	mountain shadow (> xeiÿí; < xee ‘dusk’)
√xiʼn	root	frown
xéen	noun	blowfly, bluebottle, housefly
√xit	root	furrow, plow, scratch, write, paint
xéet	noun	furrow; paddle for making furrows
wankashxéet	noun	starry flounder (< wán + kashxéet)
kashxéet	noun	print (< ka- + sh- √xit)
kooxídaa	noun	pencil (< √xit)
Tlʼanaxéedáḵw	name	legendary Property Woman, Wealth Woman (<? √xit + -áḵw)
√xitʼ	root	sweep; scrape cambium
xítʼaa	noun	broom; bark scraper (< √xitʼ + -áa)
kaxítʼaa	noun	brush (< ká + √xitʼ + -áa)
√xitl	root	drift, move out of control, rub, fog move
√xiʼtl	root	fish with herring rake
xídlaa	noun	herring rake (< √xiʼtl + -áa)
xítlaa	noun	herring rake (< xídlaa)
xéetl	noun	herring rake (cf. √xiʼtl, xídlaa; rare)
√xiʼtl	root	hem (< √x̱iʼtl)
√xilʼ	root	rub off; trouble
kaxéelʼ	noun	trouble (< ká + √xilʼ)
kaxílʼaa	noun	eraser (< ká + √xilʼ + -áa)
kooxéelʼaa	noun	tangled up mess (< √xilʼ; cf. √xisʼ)
xéelʼi	noun	crowberry, mossberry (cf. xéetlʼi)
xéetlʼi	noun	crowberry, mossberry (cf. xéelʼi)
√xisʼ	root	dive in arc (cf. xéesʼ, xéesʼi)
xéesʼi	noun	bow of boat, cutwater (cf. √xisʼ ‘dive’)
xéesʼ	noun	shin (cf. √xisʼ ‘dive’)
xéesʼ	noun	nit, louse egg
√xisʼ	root	tangle (cf. √xʼisʼ)
gux̱shaxéesʼi	noun	rattail plant (< √xisʼ ‘tangle’)
kaxéesʼ	noun	wire (< √xisʼ ‘tangle’)
√xiʼch	root	use all one’s strength
daakaxéeji	noun	barrel hoop with kaast ‘barrel’ (< √xich unknown)
tukaxéeji	noun	drum frame (< √xich unknown; cf. daakaxéeji)
xeejáa	noun	trigger of trap (< √xich unknown + -áa)
√xix	root	fall, move through space; deplete; run (cf. xíxchʼ ‘frog’)
√xeexán	root	go back to normal (< √xix + -án ‘restore’)
xíxchʼ	noun	frog (cf. √xix ‘fall’)
xixchʼikóoxu	noun	celery (< xíxchʼ ‘frog’ + kóox ‘rice’)
xixchʼikaÿaaní	noun	watercress (< xíxchʼ ‘frog’ + kaÿaaní ‘leaf’)
xixchʼitléig̱u	noun	neigoonberry (< xíxchʼ ‘frog’ + tléiḵw ‘berry’)
√xu	root	steam
xóow	noun	steambath (cf. √xu ‘steam’, xwéix̱ ‘steambath’)
xwéix̱	noun	steambath (cf. √xu ‘steam’, xóow ‘steambath’)
kaxwéix̱	noun	highbush cranberry (< √xu ‘steam’)
shantuxʼisʼkaxwéix̱i	noun	ink of octopus (< shantú + xʼísʼ + kaxwéix̱)
√xu	root	weigh down with rocks
xóow	noun	rockpile, rock weight (cf. √xu, xoon, √xun, ÿanxoon)
sítʼwanxóowu	noun	moraine on side of glacier (< sʼít + wán + xóow + -í)
sitʼkaxóowu	noun	moraine on end of glacier (< sʼít + ká + xóow + -í)
xú	noun	pubic hair (cf. x̱aaw ‘fur, hair’)
√xun	root	plural move faces; prep for trip (cf. √.a)
ÿanxoon	noun	driftlog pile (cf. √xu, √xun)
√xun	root	lose weight, be(come) thin
xóon	noun	north wind
xunká	noun	north wind birds (< xóon + ká)
√xul	root	copulate, intercourse, have sex
xóots	noun	brown bear, grizzly bear (cf. √xuts ‘overpower’)
sitʼxóodzi	noun	glacier bear (< sítʼ ‘glacier’ + xóots ‘brown bear’)
hintakxóodzi	noun	polar bear (< héen ‘water’ + táak + xóots ‘brown bear’)
√xuts	root	overpower (cf. xóots ‘brown bear’)
√xuʼts	noun	scorch, burn black (cf. √xwaʼts, √xuʼsh)
xoodzí	noun	partly burnt wood (< √xuʼts)
√xuʼsh	root	singe, scorch (cf. √xuʼts, √xwaʼts)
xóoshtʼ	noun	burnt stuff (√xuʼsh + -tʼ)
√xuk	root	dry (cf. xook, √xak)
xook	adj	dry (cf. √xuk, √xak)
gantuxoogú	noun	dry inner firewood (< gán ‘firewood’ + tú + xook)
kaxook	noun	powder, in sakwnéin kaxook ‘flour’, éilʼ kaxook ‘salt’ (< xook)
xwáa	noun	young man (plural with =ÿán)
xwáaÿi	noun	clan brother, esp. younger
xwáaxʼu	noun	sidekicks, lackeys, henchmen (< xwáa + -xʼ, rounding <? *ʷ)
√xwaʼn	root	frosty; silvered (cf. kaxwaan, x̱akaxwaan)
kaxwaan	noun	frost (cf. √xwaʼn, x̱akaxwaan)
x̱akaxwaan	noun	silver fox (< x̱aaw + kaxwaan or √xwaʼn)
x̱ʼadaatlaxwáni	noun	white whiskers (< x̱ʼé + daa + -t + l- + √xwaʼn + -í)
sʼixwaadáa	noun	kind of basket
xwaasdáa	noun	canvas (<? √xwàast unknown)
√xwaʼts	root	paint black (cf. √xuʼts ‘scorch’, √xuʼsh ‘singe’, shalxwáts)
shalxwáts	noun	redbreasted merganser, sawbill (cf. √xwaʼts)
√xwasʼ	root	suspend, hang; resemble (cf. √xaʼt)
√xwach	root	limber, tan hide (> xwájaa; cf. √xwáchk)
xwájaa	noun	skin scraper (< √xwach + -áa) 
jinkaxwájaa	noun	kind of owl (< jín + ká + xwájaa)
√xwáchk	root	paralyzed (<? √xwach + -k repetitive)
xwéi	interj	whew, tired, exhausted
√xwéi	root	tease, kid, mock, call names
daaxwéiyi	noun	reproach, source of shame (< daa + √xwéi + -í)
√xweʼn	root	dish, spoon, shovel out (cf. xwéinaa, xwénaa, kaxwénaa)
xwéinaa	noun	ladle (< √xweʼn + -áa; cf. xwénaa)
xwénaa	noun	ladle (< √xweʼn + -áa; cf. xwéinaa)
kaxwénaa	noun	brail net, dipnet
√xwen	root	almost cry (cf. √xwen ‘blossom’)
√xwen	root	blossom, flower (cf. ḵʼeikaxwéin ‘flower’, √xwen ‘almost cry’)
ḵʼeikaxwéin	noun	blossom, flower (cf. √xwéin ‘blossom’)
tsʼaxweil	noun	crow (<? *tsʼaxu + *yeʰl; cf. yéil ‘raven’)
√xwetl	root	itch (cf. kaxweitl ‘rash’, lukaxweitl ‘urge to sneeze’)
kaxweitl	noun	rash, itchy open sore (cf. √xwetl ‘itch’)
lukaxweitl	noun	tickling in nose, urge to sneeze (< lú + kaxweitl)
√xweʼtl	root	tired, fatigued (cf. xweitl ‘fatigue’)
xweitl	noun	fatigue, tiredness (cf. √xweʼtl ‘tired’; not *xwéitl?)
√xwèix̱k	root	silent, still (<? *√xwex̱ + -k repetitive; cf. xwéx̱jaa)
xwéx̱jaa	noun	rustling, quiet sound from unseen entity (< *√xwex̱; cf. √xwèix̱k)
kaxwéix̱jaa	noun	rustling (< *√xwex̱; cf. xwéx̱jaa)
yeilxwéix̱i	noun	whirlwind (< yéil ‘raven’ + *√xwex̱ or √xu + -x̱)
√xwex̱ʼ	root	emaciated
√ga	root	tide slack; delay
√ga	root	distribute, put away goods
√gàa	root	still, quiet, negative only (cf. √gaʼÿ, √gaw, √gaʼw)
gáa	pcl	in haagáashí ‘it would be good’
sdagáa	pcl	pretending (<? sí + da- unknown + gáa)
√gaʼw	root	fight (with ḵu- areal)
√gaw	root	loud, noisy (cf. gaaw, √gaʼw, √gaʼÿ, √gàa)
gaaw	noun	drum, bell, noise, clock, hour, time (cf. √gaw)
gaawáḵ	noun	saskatoonberry, serviceberry (< gaaw ‘noise’ + -áḵ ‘lacking’)
√gan	root	burn; bright, lit; sun shine (cf. gán, kagán, kagánaa, g̱agaan)
gán	noun	firewood (cf. √gan)
kagán	noun	light (cf. √gan)
kagánaa	noun	torch (< ká + √gan + -áa)
g̱agaan	noun	sun (< g̱- + √gan)
√gan	root	lean
gaan	noun	smokehole; fontanel
gáan	noun	outside (cf. gáak, gági, gáx-, gán-)
gán-	affix	outside; toilet (< gáan)
gánde	ppn	outside, outward; to the toilet
gáan.aa	noun	spare room, outbuilding (< gáan ‘outside’ + aa ‘partitive’)
gáan	noun	menstrual discharge; period, menstruation (< gáan ‘outside’)
kagaadí	noun	rafter (cf. kichx̱.ayanagaat ‘rainbow’)
kichx̱.ayanagaat	noun	rainbow (cf. kagaadí ‘rafter’)
kichx̱.anagaat	noun	rainbow (cf. kagaadí ‘rafter’)
kichxanagaat	noun	rainbow (cf. kagaadí ‘rafter’)
gichxanagaat	noun	rainbow (cf. kagaadí ‘rafter’)
ḵuchx̱.ayanagaat	noun	rainbow (cf. kagaadí ‘rafter’)
√galʼ	root	cataract in eye (cf. gáalʼ ‘clam’)
gáalʼ	noun	clam; cataract (cf. √galʼ ‘cataract’)
waḵgáalʼ	noun	cataract (< waaḵ ‘eye’ + gáalʼ ‘clam, cataract’)
gáasʼ	noun	post, housepost (cf. √gasʼ)
tayigáasʼi	noun	piling (< taÿee + gáasʼ + -í)
√gasʼ	root	move end first, fall over; clan move, migrate (cf. gáasʼ)
ḵugáasʼ	noun	fog; gray, grey (< ḵugwáasʼ)
gásʼli	noun	spreader for making a frame
gáxni	noun	cutting of hair for mourning
gáx-	affix	forward, outside (cf. gáak, gági)
gáxde	ppn	forward, out (< gáx- + -dé)
gáaxw	noun	duck
gáak	noun	outside, out in the open, out of shadow (cf. gáx-, gági)
gáak	adv	protruding (< gáak ‘outside’)
gági	adv	outside, out in the open, out of shadow (cf. gáak, gáx-)
√gaxʼ	root	annoy by noise; pray (> x̱ʼagáaxʼ ‘prayer’)
x̱ʼagáaxʼ	noun	prayer (< x̱ʼé + √gaxʼ)
√gaxʼ	root	spotted (cf. √chʼalʼ, √chʼachʼ, √gaxʼ, √kaxʼ)
√gaxʼw	root	riddle (cf. gáaxʼu ‘riddle’)
gáaxʼu	noun	riddle (< √gaxʼw + -í)
√gaḵ	root	surprise visit

xʼéesʼát	noun	shrimp (<? √xʼisʼ ‘tangled’; cf. sʼéexʼát ‘shrimp’)
chʼax̱ʼínx̱ʼ	noun	mallard (cf. kindachooneit)
