«29»
ł	not (used in subordinate and relative clauses) $ tleˑkʼ
-ła*ˑ	(g̱) tide goes out, łeˑn tide flats
ł-ła*ˑ	(∅, caus. A-x̱) melt, thaw # hin-ta`k-ła-łeˑsʼi IT small king salmon (first to run)
d-ła*ˑ	(∅ˑ, A-ch) yell
+ła	(łe?) back of head, +łi-dix̱ʼ / ła- neck # +łe`-tuˑx̱ throat, windpipe, +łe`-ka-chuˑx̱ʼ windpipe ła-kʼiˀchʼ back of head łe` < ła-ÿi $ fg.
+ła`-ka- / ła-	inside of mouth, +x̱ʼasʼ-ła`-ÿi` underneath chin $ above
+ła;w	penis
+ła`n	(IT) in g̱ax̱+ła`n rabbit blanket
ła`naḵw	(IT) barren cow
-ła`xw*	(∅) starve, ła`xw starvation
+ła;k	part of fish above tail
d-ła`x̱*	(∅) tree, bush dies, dries up; łaˑx̱ dead tree, bush
ła`x̱	red cedar
łá`g̱ak	algae that grow on rocks
łaḵt	bentwood box
łax̱ʼ	heron
łax̱ʼ	wet outer wood, +sha-łax̱ʼ skull
łáx̱ʼwgw	earth, soil (Chil)
ła`ḵʼask	black seaweed
-łe*`	(n, E1) # (n, E2) be far, na-łi-ye/ÿe distant place $ -se*`
+ka-łe	(adj.) fine; also membrane enclosing fish roe
+łe`-	$ ła (łe?)
ta`słe`ÿi	(IT) pike
łeˑn	tide flats $ -ła*ˑ
-łe`t	$ at
-łeˀtʼ* / tleˀtʼ*	slide down (pole)?
ł-łe`ł*	(∅) become lax, k-ł- become loose after spawning $ ł-łe`ł (g̱) become flabby +łe`łi (n.) flab, scrotum (adj.) flabby cf. -dleˀtl*
+(da`)ka-łe(`)ł-ti	husk (of grain)
+łetlʼ-k	(adj.) soft (solid)
hin-taˑk0ła-łeˑsʼ
łekw-a	fighting spirit
-łeˀx̱ʼw / -łiˀx̱ʼw	(∅ or n?, A1) paint red, d- (?) become red, łeˑ/ˀx̱ʼw red paint, ku`-łe;x̱ʼw-a walrus $ fg., -seˀḵʼw*, sheˀx̱ʼw

«30»
łeˀḵʼw	red snapper
i`łi / iłi / łi	don’t!
łin`	in łin`git person $ -git
łi`t*	(∅, A1) throw pl. obj. so as to scatter
−łi`t*	slide +łi`di dorsal fin, +łit-ka ridge; (∅, A1) slit, łit-a knife
łiˀtʼ	vines used in basket decoration
+łi;łʼkw	grandparent
k-ł-łiˀłʼ	(∅, A1) pull along length of sticklike object
k-łi`k*	(∅, A?) dazzle # k-łi`gu (g, I) be dazzling
a-łiˀxʼw / -łuˀxʼ*	(∅, A2) urinate (-łuˀxʼ* IT) kat.łúˑxʼu yellow
ł-łiˀkʼw	(n, A?) suck meat out of shell creature
-łiˀx̱ʼw*	$ -łeˀx̱ʼw
+łu	nose
k-łuˀn*	(∅) close eyes
+łu`ni	outer bark
łuˑtʼ	eel
łuˑł	fireweed
ÿału`łe`t / ÿa`łułe`t	cockle $ at
-łu`k*	(∅, A1) sip hot drink
ł-D-łu`k*	(∅) have “dishpan hands” (MS)
k-łu;x̱	(n) drip in steady stream, ka-łu;x̱-ja steady stream
