«59»
+gwaˀ	(encl.) uncertainty, “or what?”, (AS) gwa`tsʼa (?) # gwa-ł maybe $ (gu-).a
chagwaˀ	(interj.) aha!
gwa;	(interj.) comprehension
sʼagwan?	duck sp., guillemot, (CJ) dzagwa`n type of duck
dasgwaˑnga	round whitefish (IT)
sʼagwaˑt / sʼigwaˑt	hemlock (?) bark
kʼi-sha-gwat	smallest owl sp. (head goes around)
k-gwaˀtʼ*	(container) moves upside down
gwatʼ	(DeL) pumice
x̱ʼe-d-gwaˀtʼ*	(Tong) house is stuffy
-gwa`ł*	(∅-A1) beat (drum) # (∅-A2) hit with fist, stab with dagger, gwaˑł a blow, gwaˑł a blow, gwał-a dagger # k-(∅-Asʼ) knock on
-gwaˀtł*	roll, rock 
k-d-gwaˀtł*	(∅-caus. A?) fold up, bend, hunch up
d-gwaˀtłʼ* / gwaˀtł*?	(∅) become numb from cold
gwastłʼ	(IT, EN) the curse hand, ASL T-hand
k-gwaˀłʼ	(∅, caus. A?) curl
ł-gwach*	(∅, A-x̱) half-cook (quickly)
y̱-dl-gwaˀsh*/kʼwa`sh*	hop on one leg
+sgwach	after all, contrary to expectations
+gweˑnłi	hoof
gweˀł	sack
gweˑn	rattle
-gweˑnš	(ł, ) tinker with?
+gwe;ji	in “we.é tłèn gwéijích” (S) ‘you old thing you’ 
*łu-gwa;čʼ	rhinoceros auklet (Enrico MnH łagwaˑcʼ(a), Sw. ług°â′tc) $ guˀčʼ
