«23»
ka-ta	(du-subj) (pieces of ice) float
-ta*`	(n, P3) sleep; s- (P1 -taˑn) lie, classif. sing. non-conscious anim.
s-ta*ˑ	(∅(ˑ T), A-x̱) boil; teˑx̱ (tex̱-) boiled food
+ta, +taˑ-(k)	bottom of vessel # ki`-taˑ-nax̱ take it easy
taˑ	$ daˑ
+ta*ˑ	(n, I -ta`/ˑ(ÿ)) be fat, ta`ÿ fat
łta`ÿi	ptarmigan < Ath. ʔəłdaˑỹiˑ
taˑÿ	garden, field
-taˀw	(∅, A) steal
-ta`n*	(P3) classif. vessel, wooden class obj, gender s- this extended obj., complex obj, (obj in) bag or container, rope; (pos.) long obj. is oriented, se`g̱ataˑna berry can, tu-n-da-taˑn thought, tutan hope, trust; s- (P-nˑ/`) lie (incapable of moving), iefl. lie
-taˀn*	(A1) fish jump, naˑ-x̱+ a-g̱a-ta`n sharpened poles set up for fish to impale selves on
-ta`n*	(?, A-xʼw) catch octopus with hook, taˀn-a hook for octopus
a-k-u-sh-tan	(g̱, I) be in the habit (of going)
s-tanu/tana	(g, I) be discontented, griping
ta`n	sea lion
+ta`n	people of (a house group)
ḵu-ta`n	summer
+ta`nwu / +ta`nu / +taˑni	umbilical cord
tłe`-ka-tank	red huckleberry
ta`t	night # tat-ge yesterday # nis-da`t last night $ ÿi`-dat now
taˑł	flat open basket
-tałt?	(n, A) dissuade
tas	thread
k-ł-ta`ts/taˀts*	(∅, A-kw) knock or shake berries into basket, ka-dadz-a / -da`dza + ÿe`t flat basket for id.
ta;sʼ	in sʼagwaˑt + ta;sʼi oint. made with hemlock bark to prevent sunburn & mosq. bites
ta`sh-	$ ta`shx̱ʼan story-telling mat
+x̱ʼe`takw	heel
ash-takw	(MS) type of berry
ḵu-dz-taˑkw	(g̱) spend the winter, taˑkw winter
-taˀxʼ	(∅, A1, pl. A-sʼ, A-t) chew, bite off; s- (g̱, P3) bite into, taˀxʼ-a mosquito

«24»
shakiˑdataxʼ (-tákʼ?)	white crowned sparrow
taxʼx̱i	dentalium shells
k-ł-ta`x̱*	(∅) be moist with dew, fallen rain, nom ḵu-ka-tax̱
tax̱k	(IT) bare-topped hill
-ta`ḵ*	(∅, A-t) poke, ł- (∅, A1, A-t) poke so as to move # k-taˑḵ* (g̱, A) poke holes
u(`)x̱-ta`g̱ani/-tag̱aÿi	canine tooth
N+da`-d ÿ-s-ta`ḵ*	(∅) look after N; ku`-ta;x̱a headband; taḵ- in taḵ-shaˑ widow
taḵł	hammer
ka-ye`x̱tag̱u / -yex̱tag̱u	shavings $ -ye`x̱
kantaḵw / kintáḵw / gantaḵw	lupine
taˀx̱ʼ	slug
taˑ/ˀx̱ʼ	raised area around side of house level with housepit
ta?x̱ʼw	wart
-taˀx̱ʼw*	sink, drown
s-taˀx̱ʼw*	(?, A?) shake
-taˀx̱ʼw*	$ -teˀx̱ʼw*
te	stone # kadzitéixʼ is rocky $ ne`x`in-te/ta
ḵu`te	(IT) medium sized beaver
ḵʼa-te`ł	pitcher, jug
teˀł	pitch or pitchy wood
-teˀtłʼ	(g, I) be fat (non-human), adj. teˀtłʼ; ÿa-D-tetłʼ* (∅) get greasy face $ ta`ÿ, tiˑłʼ
ł-teˀsʼ* / -teˀsʼ	(g̱) become limp, flabby, (IT) teˀsʼ flab
-te`t	$ at
k-ł-te`x̱?	(∅) become moist, ḵu-ka-tex̱ dew
ł-tex̱	(g, I) smell acrid, yeˑł + tex̱i (wild) onion
te`ḵ	cape (clothing)
+teˑx̱ʼ	heart
gu- / kʼu-te;x̱ʼ	Eyak
a-teˀx̱ʼw/taˀx̱ʼw*	(n, A2) send smoke signals
-teˀḵʼ*	(∅, A2) twist $ -tiˀx̱ʼ* id.
-ti*`	(P1, -tiˑn) classif. general
-ti*`	(n, I3b) be # (n, A3) make oral noise # u-ti` (n, A) imitate, T also ‘scold’ $ ji`, yakw-ti`ÿi / yik- trick, sleight of hand
-ti	(?, A3) sh=dl- to be joyful
-ti`	in ḵati`yi N ‘even N’ (IT: AS, EN)

«25»
-ti`ÿ*	(∅, A/A-sʼ) patch, tiˑÿ patch
k-tiˀÿ	(∅, A) carve with chisel or adze # tiÿ-a chisel, ku`-ti;ÿ-a / ku`tiÿa totem pole
ÿ-s-tiˀÿ*	(?) be jealous of spouse
-tiˑÿ*	(∅, A) soak fish, tiˑÿi soaked fish
ti`ÿ	yellow cedar
+tiˀÿ	chin
-tiˀw	(n, A) count, read
ḵu-ti`n*	travel ÿ- (∅) recognize # s-ti`n* / tiˑn* (g̱) catch sight of, see # ł-tiˀn* / tin (n, A3) watch # -tiˑn (g, I1/I) (be able to) see, ḵutiˑn eyesight, tuˑ-nax̱ ḵa`-(ÿa-)ti`n mirror # sh+ÿ-dz-ti`na blame on self
a-ti`n* / tiˑn	(n) go away mad
ḵu-s-tin	(mod.) monstrous
ti`n-a / tinaˑ / tina`	copper (shield)
tinx	bearberry
ł-ti`t*	waves move, ti`t waves
ł-ti`t* / tiˀt*	(∅, A) calk
sh-tiˀtʼ*	(∅) tense up, +tiˀtʼi vein, jaḵ-taw-ti;tʼi murderer
ł-ti`ł*	become scarred, ti`ł / te`ł / tiˑł scar
tiˑł	shoe
tiˑłʼ	dog salmon $ teˀtłʼ
d-ti`s*	(∅, A1) shuffle, take audible small steps $ -ti`xw*, -tu`x*
k-ti`s*	make fun
k-tiˀsʼ*	(∅) stare, g̱uwaka`n + ka-tisʼ-a-ÿi large snowflakes (?) # ḵu-tiˀsʼ* (n-prim. -tiˀsʼ) search # k-u-ł-tiˑsʼ-shan (n, I) be interesting to look at $ -ti`n*
-ti`sh / -ti`sh	(g̱) become lonesome # ł-ti`shi be lonely (cause loneliness)
dz-ti`x*	(∅) have fleas, tix flea $ tu`x*
ti`xw* / tiˀxw*	stamp feet, tixw-ja stamping $ -ti`s*, -tu`x*

«26»
k-tiˀxʼ*	(∅, A2) twist into rope, tixʼ rope $ k-tiˀx̱ʼ*
k-tiˀx̱ʼ*	(∅ or n, A2) wring, twist, wind, ka-tix̱ʼ-a key, $ -te`ḵʼ*, k-tiˀxʼ*
+tu	inside; +tu`wu soul, mind, +tu`wuch, +tuˑch # te- tuˑk / ta- / ka- cave # s-tuˑ (g, I3) be clever
tu-²	$ du-² self
tu`w	tallow
tuˀtʼ	wood raised by chopping tree ?? i.e. partly-chopped out wood?
-tu`ł*	(∅ or n, A1) drill, tuł-a / tułxʼu drill, tu`łi fire drill; ł- spin; k-ł- (∅, A1/A2) roll up
x̱ʼe-d-tuˀł	(n, A-xʼw) murmur
tu;ł	(ITl) timbered hill or ridge
tuˀtłʼaḵw	clams skewered in frame for drying
tuˑ/ˀsʼ	shark
+tu;dzi	‘whiskers’ (of ling cod), wattle (of moose)
hit + ka-tu;dzi / +kʼi-ÿi- / kintu;dzi/-tu;ji	icicle
ł-tu`ch*	(∅, caus. A-x̱) (fish) has been freshly caught (caus. cook fish) # ł-tuˑch (fish) is fresh, +tuˑch fresh (fish) (adj.)
-tuˀchʼ*	(∅, A2) rub with hand $ duˀtłʼ*, -duˀchʼ
j-tu`x*	(insect) springs, hops, tuˑx sand flea, bedbug, wana-tuˑx / -tix ant $ -ti`xw*, -ti`x*
tuxʼ-	‘knee’ in ÿan tuxʼ uwatsúw ‘he knelt’
ł-tuˀg*	(∅) (brew) becomes too strong # ł-tu`k / -du`k (g, I; neg.) be clean
tuˑk	$ tu`ḵ
x̱ʼe-d-tu`x̱*	(∅, A1) spit, +łe`-tuˑx̱ throat
tu`ḵ / tuˑḵ	needlefish
+tuˑḵ	butt
tuḵłʼ	young pine # łu-tu-tuḵłʼi cartilage in nose $ duḵ
-tuˀx̱ʼ*	spew out
k-dz-tuˀx̱ʼ*	(∅, A2?) stomach is growling
+shu-tuʼx̱ʼ	ankle
tuxʼ-	(inc. noun) knee
