«35»
tłʼa-g̱aˑ	lots, quite a bit, cf. chʼa+
tłʼa`-deˑn	crosswise
-tłʼat	in ʔi`tłʼat (IT) low-bush cranberry < Ath
tłʼatk	earth, cf. chʼaˑt-wu
tłʼaˑtłʼ	something yellow, yellow color, cf. chʼaˑłʼ
ya`kw tłʼagi	(FJ) bow of boat
d-tłʼaˀkʼ*	(∅, caus. A-x̱) become wet / kᴀtłʼàkʼ or -tłaqʼ (DeL) mica AK taˑtlak
tłʼa`ḵʼwachʼ	wild rhubarb
tłʼax̱ʼkw	$ tłʼex̱ʼkw
tłʼe°n-a`	(MS) thing used to tie back hair (?) $ tłʼiˀn*
ł-tłʼeˑn	(g, I) (neg.) be pure, clean # tłʼe`taḵw+ pure, honest $ (t)łʼenxi shabby, ?MS tłʼenxi messy
k-l-tłʼeˀtʼ	grasp tightly, dl- climb holding on to something # ku`-tłʼeˑtʼ-a small white seagull, cf. ku`-chʼeˑtʼ-a
+tłeˀłi	milt, fish guts
tłʼetłʼ / tłe?tłʼ	moonfish
tłʼexwti`	(MS) ill-fitting, ugly
-tłʼeˀkw*	(∅, A) recoil, dodge, duck
-tłe?kw*	(∅, A) eat raw seafoods
tłʼex̱	usnea, cf. sʼix̱
tłʼex̱ʼkw / tłʼax̱ʼkw	soil, cf. -chʼex̱ʼw
-tłʼiˀn*	(∅, A-x̱?) tie together hair or cloth (temporarily), cf. -chʼin
+ḵʼałukatłʼi;ni	toebar
ł-tłʼi`t*	(n, A1) throw away # ḵu-tłʼid-a shovel
sha-tłʼiˀtʼ*	(∅, A?) fill with liquid, cf. -tsʼitʼ
tłʼił	hammer, +tłʼiłi penis
-tłʼi`x*	(∅) become dirty (bestrewn with trash), tłʼi`x trash # ł-tłʼi`xi (g, I) be trashy, cf. sʼi`x
-tłʼiˀkʼat	(?, A?) thread sticks through something to make rigid, tłʼiˀkʼat stick id.
tłʼikʼwx̱	worm
ł-tłʼi`ḵ*	carry with pincers, tłʼig̱-a pincers # tłʼi`ḵ finger # wan-ka-chʼi`ḵ little finger
k-tłʼu?n*	(∅, A?) squint # x̱ʼe-tłʼunkw (g, I) mutter, talk disapprovingly under breath, tłʼu;n big shot

«36»
k-d-tłʼu`ḵ*	(g, A1) drip drop by drop, ka-tłʼuḵ-ja slow drip, +tłʼu`g̱u / +tłʼuˑg̱u liver
d-tłʼuˀḵ*	become rotten and smelly, develop sore, tłʼu`ḵ sore
