«12»
-ÿa*`	(prog. ÿe`n?) move uncertainly # A+k-u-d-ÿa*ˑ (prog. ÿe`n?, Pl ÿeˑn) happen, go
u-ÿa*`	(w-) (prog. ÿe`n?, n, I1) resemble
-ÿa*ˑ	lower, sha-ÿeˀn-a anchor, ÿa-ÿeˀn-a whetstone # k-s-ÿa*ˑ (n, A-kw) comb; (MS) steam & bend O (wood)
+ÿa	face (+da-ÿiˑ-n facing) # +ÿaˑ-(k) in +ÿaˑ-g̱a through (time), +i`g̱a-ÿaˑ-(k) beach below town, +g̱una-ÿaˑ / +g̱uwanaˑ different, di-ÿaˑ across, ł-ḵu-ka-nÿaˑ-xʼ see +naˑ
+ka-ÿa`	facsimile # k-u-kaÿa` (n, A) try (S.) $ -.a`ḵw
+niÿa` / +ÿina` (-nÿa`)	in the way of, between, covering, +da`-ga`-nÿa` outside (a social group)
+(ji-)yu-ÿa`	(?) without regard for
tłiÿa(ˑ)	(dem.) further # tłiya`-(ta)tge day before yesterday
ÿan (ÿan`?)	shore (V. gan) # tłe`ÿan coast, shore
ÿan	hemlock (V. gann)
+ÿan	junior human pluralizer
ÿa`n	hunger
ka-ÿa`ni	leaves # kʼu-wa`ni / kʼu.aaní / (AS) kʼiwa`ni deer cabbage
ÿat	child, small variety # ash+/ach+-k-u-dl-ÿat (n, I) play $ ÿats # chush+ga-da-ÿat single-moiety child
ÿa`t*	here
-ÿaˀtʼ*	(n, I1) # -ÿatʼ (g, I) be long $ -ÿaˀchʼ*, -ÿaˀtłʼ*
-ÿaˀtłʼ*	(n, I1) be short $ -ÿaˀchʼ*
-ÿats-kʼu, pl. -xʼi	small $ -kʼi+ÿats-kʼu / -kʼatskʼu small
k-d-yaˀsʼ*	(g̱) become smooth
k-dl-ÿaˀsʼ*	(P3) move foot
(ka-)ÿaˀsh	platform, k-ł-ÿaˀsh build platform
d-ÿashḵ	(g, I) be scarce
-ÿaˀchʼ*	(n, I1) be too short $ -ÿaˀtłʼ*, -ÿaˀtʼ*
ÿa`k	mussel
a-k-u-ł-ÿaˑkw	(n, I) deny
ł-ÿa`ḵw* / ÿaˑḵw	(?) bequeath, make a simile # ł-ÿa`x̱aḵw (?) plan

«13»
ÿe / ye	place # g̱a`-ÿeˑ-nax̱ʼa (IT) right side # (wu`ch) x̱ʼa`kdiÿeˑ-nax̱ sporadically, from time to time # łidinax̱kʼi-ÿeˑ-de not known where, to whereabouts unknown # tsa`tsguÿeˑ-g̱a` finally, only then
k-s-ÿeˑ	(g, I3) be strange
+ÿe`t	$ +.at
+ÿeˀsʼ	dark, iḵ-ÿeˀsʼ / g̱aÿeˀsʼ iron $ yeˀsʼ*
+ÿi`	under # da/di-ÿiˑ ((da/di-)ÿin-) (dir.) below, down # wan`inax̱ (< wan-ÿi`-nax̱) / (I) wanÿi`tu`wu secretly # kʼatłʼgi`nax̱ (< kʼatłʼk-ÿi`-nax̱?) quietly
yagiÿi` / yigiÿi` / yakÿi`	day
k-s-ÿiˀÿ*	(∅, A) tie together long objs.
+ÿiˑÿi	former
+ÿi`n	during (interval of time, e.g. nighttime, wintertime)
sha-ÿiˑn	nail
d-ÿi`t*	(∅) become oily # s-ÿi`di (g ,I) be oily
k-ÿiˀt	(n, A(-kw)) stretch
+ÿiˑt	son (voc. ÿitkʼ)
+ÿis	(pp.) for (+x̱ʼe`s < x̱ʼe-ÿis)
łe`ÿis	fir
ÿi`s / ÿi;sʼ	wedge
ÿi`s	$ ÿe`s horse clams
ÿiˑs+	new
ÿi`sh	pull
ÿiˀsh	leech
k-dl-ÿi`ch* / -hi`ch*	pl. fly, x̱ʼałʼ-da`-ÿiˑj(aÿ)i/-ÿeˑÿi/xʼatʼ-da`-ÿiˑjaÿi plover
O-k-s-ÿi`x*	(IT) (∅, A2) pull sinew thru teeth & get meat off, O-ÿa-k- bite O (hide) to soften it
+ÿi(k)	inside vessel # ka`wa-ÿik nowhere, “thin air”
-ÿi`ḵ*	pull, draw # k-dz- (∅, A2) fish with line, ÿig̱-a string for pulling (hammer), ka-ÿig̱-a hoisting line, sha-na`-x̱+ka-ÿiˑḵ scarf
-ÿi`ḵ*	(P3?) animal carries in mouth, bites
ÿi?ḵ	part of boat
+sa-ÿi`ḵ	next day, cf. se`g̱án tomorrow
