«60»
+ka	surface (+kaˑ-xʼ according to, (existing) on) $ -kat
ku`ka	in +x̱ʼa-ku`-ka answering P
a-u-dz-ka`	(g-I) be lazy
k-u-d-ka`	(n-A) make gestures # k-u-kaÿa` (n-A) (S) try $ -.a`ḵw*
-kaˀÿ*	(n-prim.-ka`) measure, weigh, ka`ÿ / kaˑÿ a measure, measuring device
ÿ-dl-ka`n*	(∅) dance in return
kan-a	flag (maybe originally “dance staff”)
chu`kan	grass
+ki`kan	going to see
ḵuwaka`n / g̱uwaka`n / g̱uwakaˑn	deer
+kaˑni	sibling-in-law
kat	spearhead
-kat	in +da-kad-in	facing # ł-da-kat all # chʼa+kʼi`-kat at least
ka`t	long flat basket # jin-ka`t/kaˑt ten
tsʼawka`t / tsʼankwa`t	spider
kaˀtʼ	stick for digging clams, planting
+kaˑł-kʼw	woman's brother's child, voc. kálkʼw $ +keˑł-kʼ
kats	calcium from clam shells, white bird excrement # kał-kats-ḵ/ḵʼał yellowneck clams
d-kaˀsʼ*	(∅) get algae, kaˑsʼ algae
s-ka`k*/kaˑk	(n-I2) # s-ka`k/kaˑk (g-I) be thick
+kaˑk	mother's brother
+ka`k	(IT) flesh on inside of skin
+kaˀkʼ	forehead
k-j-kaxʼx̱ / k-dz-gaxʼx̱	(g-I) be spotted # kaˑxʼ spruce hen, grouse # x̱as-kaˑxʼ cross fox (or qaˑxʼ? no)
+kax̱i	sap # ł-kax̱ (cambium) is juicy # (IT) ł-kaˀx̱* sap runs full
kax̱-	in +kax̱-ÿi` ceiling

«61»
łʼag̱akax̱	west wind
tsʼiˀkax̱kʼw	jacob berries $ under tsʼiˀk-
-ke*?	get caught in throat (du séil uwakéi)
k-ke*ˑ/`	track, follow trail # k-s- (n, g̱-A-kw??) unravel, undo (at-)ka-keˑn yarn, x̱ʼaka-s-keˑn unfinished basket, ka-sʼi;t+da-keˑgw-a wrench, wuˀsh-nax̱+x̱ʼa-ka-keˑx̱i chain # k-d- (n??) do poorly # ka-kekw-ti unraveled part
ke`t	$ at
wu`sh+keˑt	racing
se-ku`-keˑÿ-a	sash (cf. ku`-geˑn-a)
keiˑtʼu	(Haida ki-tʼaˑw spear) stone battle axe, pick
-ke`ł*	(∅) become calloused
k-ł-ke`ł*	(∅-A-sʼ, A-x̱) soak
+keˑł-kʼ	man's sister's child (voc. kélkʼ) $ +kaˑł-kʼw
ke`tł	(T keˑtł) dog
keˀtł-.adi / keˀładi / ke;dladi	seagull
-keˀłʼ*	(∅-A2) take apart, untie $ -ke*ˑ
D-keˀłʼ*	pl. run away (cf. -ha`n*) caus. O-łʼ-kełʼ* chase pl. O away
sh-keˀłʼ*	(g̱, ∅-A-tʼ) burn to ashes (for snuff), keˀłʼ/kełʼ-tʼ ashes
k-ke?ts*	(∅) become alert, (EN) urge/goad to do sth. (wrong)
k-ke?ts*	(∅) (dry snow) becomes loosely piled up, ka-kets-kw light dry (snow) $ -kexwk
ł??-ke`sh*	(A2) spawn
ke`sh-	in ke`sh-tiˑł moccasins 
-kexwk	(IT EN -kexwt) (g-I) be light, insubstantial, +ka-kexwk light dry (snow), k-dz- (g-I) be porous, kexwk/gexwk pumice $ gextłʼ
+ke`gu	lungs
ke;gan	(FS) great white owl
k-d-keˀxʼw*	crane neck
a-k-j-keˀkʼw	blunder
+kiˀ-kʼ	(voc. kikʼ) younger sibling of same sex (ck Tongass kiˑkʼ)
(da/di-)kiˑ	(kin-) above, up
+ki`-ka	across, on the other side < ki`g=ka ??
+ki`ÿ	knee
łki`ÿi-ÿaˑ-g̱a`	for longer (than necessary, seemly)

«62»
kin-tu;dzi/tu;ji	icicle
sh-kiˀn*	(∅) become bothered (esp. by noise, talking) # sh-ki`na (g-I) be noisy
a-ki`t*	(??-A1) snore
kiˀt	killer whale
-kiˀtʼ*	become jammed # (∅-A1, A-t) pry up, plow, kitʼa peavy, ku`-kitʼ-a shovel
kiˑł	diving duck
-ki;s*	(∅) become informed (??), ash êe awlikís (Boas)
kiˑs	bracelet
ł-ki?ts*	(∅-A??) singe fur off $ -hi`ts* (< *ł-d-??)
ł-kiˀtsʼ*	tip, rock # ach+k-u-ł-kitsʼ-a play on a seesaw, ku`-kitsʼ-a seesaw
k-kiˀsʼ*	(∅, caus. ÿ-k-ł-, A2) become exitinguished
-ki`ch*	(∅-A-xʼ) gasp (as if startled), sob, cry oneself out of breath and gasp
ÿ-ki`ch*	(∅-A??) have housewarming party
ł-kiˀch*	(∅) putrefy (esp. dead fish), kiˀch dead fish odor, +kiji (??) animal excrement
kich	tinder
+kiji	wing
kich- / gich- / ḵuch-	down feathers $ -ga`di
k-kiˀk*	(∅-A-sʼ) shake (out)
+kik	(IT ki`k) paired with, +kigi one of a pair, half (of symmetrical obj.)
kiks-ya;n	baby killer whale
+ki`gi	(DeL, EN) afterbirth
+kiˀkʼ	$ kiˀ
s-ku*`	(∅ˑ) come to know
-ku*ˑ	spit (liquid) (n- hold liquid in mouth)
+ku, +ku`wu	(bird or fish) tail
+ku`-ka	underlying motivation, reason, meaning (of speaking)
ku`w/kuˑw	lady-slippers
kuˑn	flicker (bird)
+kuˑn	hem
kut	nest

«63»
ḵa`+ÿi-kuˀtʼi	button $ uˀtʼ
+ḵʼa-lu-ka-kultʼ-i	hole in rawhide for pulling end of same through
+ku`ł	navel
+ji-kuˀł	back of hand
d??-ku?tł*/ku?tłʼ	(??) (hair) becomes puffed up $ -kuˀchʼ*
ł-kudl*	(∅) fluff up (EN)
a-kuˀtłʼ	(∅-A??) fart $ -kuˀchʼ*
a-ku`s*	(∅-A1) (dog) is alerted/has doggy dream
ku`dzi	(interj.) amazement # ł- (g-I) be amazing
kuˑsh-	in kuˑsh-da` land otter
+ka-kushtʼ-i	pocket of pitch, pitch, bud (??)
k-dl-kuˀchʼ*	(∅, caus. A2) become curly $ -ku?tł
a-kuˀchʼ	(∅-A??) fart $ -kuˀtłʼ*
k-ł-ku`x*	(∅) dry up, sha- (∅) become thirsty, sha-ku`x thirst # k-s- (∅-A2) bail $ -xu`k*
k-dz-ku`ḵ*	(pile of objs.) fall, fish rush in a boiling mass, te+ka-kuḵ-xʼ rockslide # (∅) liquid bubbles, kuḵ-ja drip with bubbles, kuḵ-dla large bubbles (from whale)
kuˀḵ	pit, underground cache, cellar
kuˑx̱ʼ	dry wild celery stalk, sha-da-kuˑx̱ʼ hat with sections stacked up 	

