«10»
-ya*ˑ	(-yaˑ-, prog. -yaˑn) pack, yaˀn-a / yaˀn-adi pack
ya(ˑ)	(dem.) here # chʼa+yaˑ-kʼu / +yakʼu / +ya`kʼu right away
ya`	sea trout
dandawu`ya`	(IT) kind of ground hog
.ayahi`yaˑ	curlew
dagitgiyaˑ / digitgiyaˑ	hummingbird
ne`stʼiyaˑ	plant sp.
k-s-ya`ÿi	be goofy
k-dz-ya`ÿi	be submerged
yaˀÿ	whale
aya?n	Athabaskan < Ath. {kʼə,ʔə}-yuˑn different
nukshiyaˑn / łukshiyaˑn	mink (C. diff.)
kiksya;n	baby killer-whale
ka-ya`t* / ÿa`t	pleat (check akawliyaat)
kich-ÿa`t	tern (V. kičgat)
sha`yaˑł	hawk
taya;dzi	(IT) honeycomb ice
chʼiya`sh	small canoe (Ath.)
yaxwchʼ	$ yuxchʼ
ya`kw	canoe
+yax̱	(pp.) like
+ya`x̱	bank, side edge
-yaḵw	$ giyaḵw
ye	$ ÿe place
kuˑna`ye`	(IT) chipmunk
yeˀ	thus $ yuˀ # da`ḵweˑ sa what sort of thing
sha-k-ł-yeˀn*	(∅, A/A-xʼ) twirl, wave, wag # xuˑn#ka-yen-a (IT) buzz made with button and string
yeˑn	sea cucumber
ł-ye`ł	(∅) deceive # ḵʼe-ł-yeˑł (g, I) lie, yeˑł raven
k-d-yeˀłʼ	(∅, caus. A?) become calm, ka-yeˑłʼ peace
yeˀłʼ	elderberries

«11»
ye`s / ÿi`s	horseshoe clam
ye`s	(ye`su+) autumn (V. esi)
ye`su	still, yet, just now (V. gesu) (check ÿ)
k-d-yeˀsʼ*	(∅, caus. A2/A-x̱) become blackened, discolored # yetsʼ black dye $ ÿeˀsʼ
ku`ye;x	(IT) camprobber, Ath *g̯uˑžə(x̯)
ł-yek	(g, I) be roomy
ye`k	(∅) become animated, alert # ÿa-ye`k, ÿa-s-yeˑk (g, I) be fast, yeˑk shaman’s spirit $ -yik
ÿ-k-ł-yeˀk*	stagger
u-ye`x̱*	(n, A3) be absent
ł-ye`x̱*	(∅, A1) make, build # k-ye`x̱* (∅, A1) whittle, shave, ka-ye`x̱-tag̱u shavings
yeˑx̱	deadfall
yi`s	$ ye`s horseshoe clam
yiˑsʼ	large mussel
+ÿa-yik	sound (of animal) $ ye`k
x̱ʼe-dl-yu*ˑ	adopt
+yu(`)	stomach
+yu-wa`	between (natural features)
x̱a`yu`wu	“poison ivy” ?, x̱a`he`wu?
yu(ˑ)	(dem.) yonder
yuˀ	thus (as preceding) # chʼa+/tsʼa+yuˀkʼ immediately $ yeˀ
yu`	prev., back and forth, up and down
yuxchʼ / yaxwchʼ	sea otter
k-yuˀk*	(∅, A-sʼ)	shake (out)
yu`ḵ	cormorant
d-yuˀx̱ʼ	(∅) become soaked
-yuˀx̱ʼ	(∅, A1) gnaw

