«39»
ÿa-λ-dzaˀÿ*	grow beard, -dza`ÿi thick hair (nose, hair, whiskers)
dzanti	flounder
ÿa-dzanłʼ	(Y.) lumpy face
k-dza?s*	(∅) become winded
ł-dza?s*	(∅, A?) lace, dza`s/dza;s thonging, lacing
dzagwe`t	(IT) deadfall
dze`t	ladder
ł-dziˑ	(g, I) be difficult
k-d-dziˀÿ*	balk
-dzi;	type of dog (Athabaskan?)
dzi`n-a / dze`n-a	snare to catch small animals by the leg
dzinx̱i	(Sw?) kind of medicine
dziskʼw / tsiskʼw	moose $ tsiskʼw / dziskʼw owl
hin-x̱u-ka-dzi;dzi	sandpiper
wadzix / watsix	caribou
O-ÿa-s-dzixʼ	(∅) (IT) cover O’s eyes ← check, should be O-ÿa-ł-dzixʼ*
-dziˀxʼw* / -dzuˀxʼ*	(∅, A) crush clams together to get juice, dzi;xʼw / dzuˀxʼ butter clams
-dzu*` / -dzuˀw*	(∅, A-t) hit by throwing (-dzeˑ-x̱a / -dzuˑ-x̱a / -dzun-x̱a miss by throwing), dzun-a missle
ka-dzu;s(t)	(?) (snow or rain) skitters along water or ground
+dzuk	back of person
-dzuˀxʼ*, dzuʹxʼ	$ -dziˀxʼw
O-ka-uˑ-dzisgʷ	(na, A) call O (dog)
