«56»
du-ga*?	(∅) tide become slack, k- (n) delay
k-ł-ga*ˑ	distribute, put away goods
d-ga`	(g-I) (neg.) be still # k-s-gaˀÿ* $ -gaˀw* move noisily, aadé sh kawdzigáy
ga;	in ha(`)+ga;-she it would be good
+sdaga;	letʼs pretend
ḵu-ł-gaˀw*	(n-prim-ga`w) fight # ł-ga`w (g-I) be loud, noisy, ga`w drum, clock $ -ga`
ga`waḵ	serviceberries
-ga`n*	(n, caus. pl. A-tʼ) burn, +gantʼi burnt # a-k- fire starts, gan firewood # k-d- (∅) shine, ka-gan light, ka-gan-a torch # a-(g̱) sun shines, g̱a-ga`n sun # k-d-gan (g-I) be bright, illuminated
sha-k-ł-ga`n*	lean
ga`n	smokehole, +ga`n fontanel
gaˑn	(gan-) outside
+ka-ga`di	rafters # kich-x̱+/ḵuch-x̱+/a-(ÿa)-na-ga`t/kichxana-ga`t/gichxana-ga`t rainbow
gaˑłʼ	clam, cataract in eye # wakshi- has cataracts
-gaˀsʼ*	move end first through space, move rapidly end first # (n-E2) clouds move # ł- (family or clan) moves, migrates $ below
gaˑsʼ	post $ above
+gasʼłi	spreader (for making frame)
gaxni	party, celebration
gax-	(w/ -de) forward $ ga;g (EN: gaxw-de)
gaˀxw	duck
ga;k	(gagi) out in open 
d-gaˀxʼ*	become annoyed by noise # x̱ʼe-d- (∅-A1/2) pray, x̱ʼa-ga;xʼ prayer
-gaxʼ-x̱ $ -kaxʼ-x̱	spotted
a-dl?-gaˀxʼw*	(∅-A?) riddle, ga;xʼu riddle
-ga`ḵ	(g̱) pay a (surprise) visit

«57»
-ge*`	(n-I1) # -geˑ (g-I3) be big # yeˀ+g-u-geˑkʼ/geˑnkʼ (n-I) sg. is small # yeˀ+g-u-ge*`/gi*` (n-I) pl. are small
ÿa+sh-ge*?	(n-I1?) not want to share
ÿa`+ḵu-dz-geˑ	(g-I3) be intelligent, wise (neg. j- be foolish), +da`-ÿa`+ḵu-shu-s- understand
+geˑ-de	against, opposing # +ka-ge face to face, meeting ka-geˑ-nax̱ quietly # -ji-ÿa-geˑ-x̱ messing up handiwork # dagi-ÿi-ge/dagi`ÿ-/digi`ÿ-/dagin`-/digin`- middle (prob. < dagi-ÿa-ge) # chʼa+(nich+)ku-geˑÿi aimless
+(a)ge/(a)gi	(yes-or-no question)
tatge	yesterday
kusʼu`łgéˑ	(IT) willow grouse
ku`-geˑn-a	sash
s-geˀÿ*	(∅, pl. A-sʼ (ł-)) pay back # ł-ge`ÿaḵw (?) claim as payment
-ge?t*	walk quietly $ kʼe`t [NOTE: “$ kʼe`t” is crossed out]
ge`t	$ at
kʼagana;ge`t	trap for sticklebaks (kʼa`gan)
tuwulage;łʼ	braided intestines
k-d-getł	(g-I) be frail
ge;s	(interj.) calling dog, k- (n-A) call dog
gexwk	$ -kexwk
gextłʼ	mica $ kexwk
d-ge;gw	(IT) (roe) is loose, +ka-da-ge;gu loose (roe)
d-geˀḵ	(g-I) come to harm [NOTE: “not be suitable” crossed out], die # dza-geˀḵ weakling
k-j-giˀn*	(∅) wrinkle, caus. O-k-sh-giˀn* 
+gi`ni	tail flipper
dz-gi`t*	anim. moves rapidly, falls # Adv. +dz-(n) act thus # k-u-dz-gidaḵw (?-A) show off
łin`git / łi`ngit	person, Tlingit
giˀłʼ	spadix of skunk cabbage, (Yak) fish eggs made crunchy by soaking in fresh water
dl-giˀts*	(∅) get rash, hives, gi`ts rash
áx̱ wuligíts	teetered (ready to fall)
k-d-gi`sh*	(∅, caus. A1, A-sʼ, pl. A-xʼ) become soaked, gi`sh kelp

«58»
gich-	$ +ga`di, cf. giǯ-x̣aˀn Ketchikan
+giˀk	stern [NOTE: of boat]
sʼi-gi;gi	fish cut a certain way
+giḵłʼan	palate $ kʼiḵłʼan
-gu*ˑ	(∅?-A-k-t) poke, penetrate by poking, +da`-it_na-gu;wu actions # s- (n) id. # ÿ- (pl. boats, sea mammals) go in a group
+gu`wu	(gu-) stump
gu`+sa	(gu`t+N+sa) what place, where, gu`tʼa+sa whereabouts (< gu`t+a+sa)
s-guˑ	(g-I3) (neg. sh-) be joyful, fun, sa-gu joy, fun
gu-	dubitative $ gu.a`, gusheˀ
-gu	$ -gu`t
-guˀn*	(neg.) not get to take advantage of opportunity
gu`n	spring, well # gun-tu bosom
+gu`ni	(yatee) (is) careful, cautious with P 
+guˑn	isthmus, +łu- nose bridge
+sha-guˑn	instrument, tool, ancestor $ +ge`-nÿa under +niÿa
ne`guˑn	nagoonberries
gunłʼ	burl # k- (?-A-x̱?) try hard
gunx̱a`	abalone
-gu`t*	sg. goes on foot # s- (pl. A-xʼw) carry on shoulder # d- (g) sg. stands up (also -ha`n*) # ḵu-de+k-d- (∅) become eclipsed, ḵu-de+k-da-gu`t eclipse
gu`tł	bump, hump $ gu`ch 
-guˀłʼ*	(∅) close one eye # -guˑłʼ (g-I) be one-eyed, (+)guˑłʼ lone eye
+gu;s	vagina
ḵu-ł-guˀsʼ	(g, g̱?) become cloudy, guˀsʼ cloudy sky, ḵu-guˀsʼ cloud $ -gwaˀsʼ*
gush+deˑ	(interj.) desire to get started $ guˀk # i+guˀsh+xʼwan (interj.) encouragement # guˀš waʔeˑǯ [NOTE: no translation given] $ (gu-).a`
+gu`sh	thumb # gu`shaḵw/gu`shuḵ nine
g̱an-gu;sh	two-eared headdress
-gu`ch*	take (food) to someone [NOTE: ł classifier crossed out]
gu`ch	hill # (IT) ÿanaa-da-gu`ch arched cover (on chest)
tła`kw+shu-wu-gu`ji+ge	(interj.) amazement
i+tla`+kwshe-ya+gu`dli+ge	(IT) exhortation, encouragement
+gu`ch-kʼ-i	as much as _ can handle (self or other)

«59»
+łu-guˀchʼ	lobe of nostril (cf. kʼuˀchʼ)
-guˀk*	(∅-A, A-t) peck, gan-da`-(da-)guˀk woodpecker
+guk	ear
+guksh / gukshu / guksh(i)-tu	corner
gan-gu`k	around fire
guˀk	(interj.) desire to get started $ gush (prob. < guˀguˀ
-guˑk	(g-I) (pos. ∅, sh-, neg. usu. sh-) know how (g̱) learn how, +guˑgu expert # k-ł-gukch (g̱-A) teach how # k-gukłʼ (g-I) be eager to learn how
-guˀxʼ*	(∅-A) dip (water) out, guxʼ-a cup
gu`x̱	slave # gux̱-ḵu slavery
-gu`ḵ*	push, łu- pl. run # k-dz- (?-A2) (hair, plants) push up (out of scalp, ground)
-gu;ḵ	+ka-guḵ-xʼu dried fish eggs 
