«42»
-sʼa*ˑ	(∅ˑ) ask for, claim something about to be destroyed; sʼáaÿadi something claimed as payment
sʼaˀw	(dungeness) crab
sʼan	$ sʼin
sʼa`n	limb
+sʼa`ti	master, boss, expert
-sʼaˑtʼ	(g-I) be left-handed # sʼatʼ- left
dl-sʼaˀsʼ*	dance (sliding feet) # ḵu- (?-A1?) dance (by swaying) # sʼaˀ/ˑsʼ finch (?)
sʼa`ch	fern # gan-da`-sʼa`ji bee
sʼax	starfish
sʼaxtʼ	devil’s club
-sʼa`xw	stack # sʼaˑxʷ hat
kałsʼaˀk / kanałsʼaˀk(w) / kałtsʼaˀkw	squirrel
sʼa`x̱	groundhog
sʼa`ḵ	bone
sʼaˀx̱ʼ	gray cod
sʼe	clay
sʼe	(interj.) astonishment
sʼe	(encl.) first
+sʼe`	$ +sʼi
na`g̱asʼeˑ	fox
-sʼe`t	$ at
sʼeˀłʼ*	tear, rip, sʼeˑłʼ wound # k- (∅-A1/2) tear apart, peel # sʼełʼ rubber
d-sʼe?kw	$ tlʼe;kw duck
sʼix̱	swamp hemlock
sʼeˑx̱wani	lichen that grows on trees
sʼiˀ	salalberries
+sʼi`ÿ / sʼi` / sʼe`	eyebrows
+sʼi(ÿi)-tu	corner of roof

«43»
sʼin / sʼan	(wild) carrot
sh yawdlisʼín	grimaced [-xʼin?]
sʼi`n-a	lamp
-sʼi`t*	(∅-A2) tie, ka-sʼi;t screw, + sha-ka-sʼidi calyx
sʼi?tʼ	(Sw) whale like killer whale
l-sʼi`s*	be blown by wind, sʼis-a sail, cloth # ł-(∅) be tiresome, offensive to # -sʼiˀs* wind blows water, snow, (ka-)sʼiˀs-ja wind ripples, snowdrift $ -chʼi`sh splash
x̱ʼe-d-sʼiˀsʼ*	(∅-A1) squirt water # (∅-A2?) whistle under breath
ł-sʼi`x*	(∅) become spoiled, start to rot $ -sʼi`xw
sʼi`x	particles of dirt, lint, trash $ tłʼi`x
k-ł-sʼi`xw*	become sour # k-ł-sʼi`xu (g-I) be sour
sʼi`k	black bear
sʼiksh	hellebore
ł-sʼi`kw*	(∅-A-x̱) become crisp # ka- (snow) is crusted (early spring)
sʼixʼ	bowl, dish # sʼixʼ-g̱a moss
sʼiˑxʼat / xʼiˑsʼat	shrimp
k-ł-sʼiˀxʼw*	adhere # k-ł-sʼiˀxʼu (g-I) be sticky
-sʼi`ḵ*	(n-A-sʼ) suck out
-sʼi`ḵ*	(∅) get smoky # (n?-A2, A-x̱) smoke, sʼi`ḵ smoke, ḵu-sʼi`ḵ bluish haze
-sʼiˀx̱ʼ	(?-A?) gush, have runny diarrhea, sʼi;x̱ʼ diarrhea
-sʼu*?	(∅ˑ-A?) limber a root or branch, sʼu thin roots or branches
-sʼuˀw*	(∅, n-A) chop, ka-sʼuw-a chopper # sʼu`w greenstone
-sʼuˀn*	$ tsʼuˀn*
a-k-sʼuˀn*	(?-A?) make kissing noise (u- ?)
+sʼudi	(IT) lower foreleg
x̱ʼe-d-sʼutʼ	spit
sʼusʼ	harlequin duck
ł-sʼuˀsʼ*	(∅-A1) thread on stick for drying, sʼuˑsʼ stick threaded thru drying salmon # sʼuˑsani pine cones
-sʼuˀshkw	(?-A) pinch flesh
sʼu`k	barnacle
+waḵ-ka-sʼuˀxʼ	blocking view
sʼuˑḵ	rib

«44»
gisʼuˑḵ	northern lights
(waḵ-)-ka-ł-sʼuˀx̱ʼ*	(∅) have dried matter around eyes # waḵ-ka-ł-sʼu;x̱ʼ gaˀxw scoter
