«40»
tsa`	hair seal # a-dl-tsa` (n-A) belch
tsaˀ / tsa	then
u-tsaˀÿ	(g̱-A) ask to go with one
tsałk	ground squirrel (diffused)
k-tsa?tl*	(∅, caus. A?) become plastered
tsaˀs	I wish $ chʼas
tsa;ts	plant with edible roots (Hedysarum?)
-tsaˑkw	(g-I) last a long time
tsaˀxʼ	gloves
-tsa`ḵ*	push (with sticklike obj. end forward, # k-(g̱-A2) poke, prod with stick, tsag̱-a pushing instrument: pole, rod, antlers # tsa`gałʼ/tsa`g̱-a spear # ḵu-k-dl- (∅-A1) walk with stick, poke ground, w-u`-tsa`g̱-a cane
ÿ-tsa`ḵ*	(∅) refuse (person) (u- ?)
+tse`ÿi / +tseˑÿi	sweetheart
k-tseˀt / tseˀtʼ	plant with edible root
k-tse`ts*	(∅-A2) cause pain
tsin	muskrat (diffused)
-tsi`n*	(∅?) move body part # ł- (∅?-I-kw or A-xʼ) make strong # -tsi`n (g-I) be alive, stir, tsi`n-e`t sold-ribbed brown bear, # ł-tsi`n (neg. -chi`n, g-I) be strong
-tsi`s*	float, swim surfacing intermittently # ł- (P) be afloat, ka-tsi`s buoy, large float for halibut fishing # (MS) O-ḵʼa-ka-ł-tsiˀts* (∅, A-x̱) simmer O (D- simmer)
tsiskʼw / dziskʼw	owl $ dziskʼw/tsiskʼw moose
watsix	caribou $ wadzix (diffused)
-tsi`k*	(∅-A1, pl. A-sʼ) roast on stick, tsiˑk roasting stick
-tsiˀxʼ*	$ -tsix̱ʼ* [NOTE: strangle $ Naish & Story]
-tsi`x̱*	(∅-A-t) kick

«41»
tsiˀx̱w*	$ tsuˀx̱* 
tsix̱ʼ	(∅) strangle
tsu(`)	again, also # tsu(ˑ) (encl.) also
-tsuˀw*	push pl. sticklike objs. end forward # (g̱-A) push in pl. sticklike objs. # k-dl- (?-A) plant with stick, ka-tsuˀw-a planting stick # dl- (g) move household (lit. ‘pull up poles’, prob. orig. ‘move camp’)
-tsuˀx̱*/(-tsiˀx̱w*)	(∅-A?) dam up # tsu;x̱ corral for moose, rabbits
ka-D-tsux̱ʼ*	(∅) (beads) come off string # O-ł- caus take O (beads) off string
