«45»
+sha	head # +shaˑn inside of head # +shaˑ(-k) head of river, lake
-sha*`	(g-A1) bark
-sha*ˑ	(∅ˑ) marry (a woman) # -sha;ÿ? (?) marry (each other), wùsh dishây (clans) they are intermarried, wu`sh D-shaˑÿ (I); wu`sh+da-sha;ÿ married couple # -shaˀxʼw (g̱-A) get a wife # shaˑ(ʷ-) women, sha`wat woman, sha`t-kʼ young woman # +shat wife
sha`	mountain
sha`w	gumboot (cf H. chaˑw sea creature)
d-sha`n*	(∅) become old, gray, sha`n old age, old person
-shaˑn	$ i`shaˑn poor, pitiable
-shaˀt*	(g) grab # ł-(g̱-P) catch, capture, hold, g̱ałshaˀtadi captive, shad-a funnel
a`shat	steelhead
+shat	wife, sha`t-kʼ young woman $ -sha*ˑ
+sha`di	sprouts
+shatx̱	older sister
shał	spoon
shaˑł	fish trap (tšaˑł in Yakutat pl. nm.), sàˑk tšàˑł “eulachon trap”
-shasʼḵ	$ -shisʼḵ raw
-shaˀsh	(n) wear out
shachk	swamp
shaˑchʼ	young herring
shaˑchʼ	plant that grows on trees, as-xʼa`n+shaˑchʼi bird sp.
shaˀk / sha`k	timothy grass, sha`k yátxʼi small pieces of driftwood (VDict p.43)
+shaˑk	$ sha head
shakw	$ shikw strawberry
sha`x̱	gray currants

«46»
k-sha`ḵ*	(∅, caus. A-x̱) become winded (caus. hunt by exhaustion) $ -sa`ḵ*
sha`ḵ	driftwood
u-shaˑḵ	(n-A) deny
shaḵʼw / shuḵʼ	legendary wolf-like animal
she / shi	blood
-she	in ha`-she (excl.) surprise, ha(`)-ga(`)-she it would be a good thing # daˀ sheˀ that’s enough, stop it!
shé, shéʔe	(IT, DSh, EW) ‘have you seen _?’
gusheˀ / gushe, +kwsheˀ / kwshe	I guess (so) # gusheˀł / akwsheˀłʼ (interj.) annoyed ‘I don’t know!’
sheˑÿi	sitka spruce
she`t	$ at
she`xw	$ shi`xw close quarter arrow
sheˀx̱ʼw	red alder $ łeˀx̱ʼw, -seˀḵʼw, šu`x̣ʼ
-shi*`	(g-A3) sing, shi song
-shi*`	reach hand, touch; d- help # ḵu- (n-A1) search # ł- (n-A-kw) caress, stroke # shi`ÿ right (hand)
a-d-shi*	hope
shi;, akshi	(excl.) getting attention
ḵukanshi(;)	publicly (?)
shi	$ she blood
shi`ÿ	right (hand) $ shi*`
shi`ÿ	limb, knot
shiˑn / shi`n	wooden bailer, large spoon
k-shiˀtʼ*	crowd, shove
ł-shiˀsʼ*	(∅-A1, A-x̱) squeeze out guts
ł-shisʼḵ / shasʼḵ	(g-I) be raw, (+)shisʼḵ/shasʼḵ raw (flesh)
ł-shiˀsh*	(?) try to outdo at feast, (MS) Os-ł-shi°sht (?) Os “has to correct one’s mistake in a nice way”
ke`shish	alnus, alder
ł-shi`sh*	(∅-A2) sip # (IT) ši`š inconnue # sʼełashi`sh flathead duck

«47»
ł-shi;sht	squeeze out contents $ ł-shiˀsʼ*
shi°sht	(Sw) lucky gambling stick
shiˑch+	female
shi`xw / she`xw	close quarter arrow
+shi`xu	(IT) part of moose alimentary tract
shikw / shakw	strawberry
k-dl-shiˀkʼw*	(∅) get cramps, kashiˑkʼw cramps, electricity
k-shiˀx̱ʼ*	(n-A1) praise, kashiˀx̱ʼ praise
-shu*?	(road) ends, (a)-twu`shu / (a)-du`shu (num. suffix), num. + five from *num. ʔat=wu`šu (v.noun) “ending there at num.” # (n-E3) sticklike obj. extends, (g̱-E3) sg. hang ʔáx̣ ɢa`šúˑ # ka-d- (ridge) extends
k-shu*`	(n) be affected, get drunk
gishu` / gushu`	(Ch.) pig
kʼinashu;	pneumonia
shu;sʼi+hidi	house for smoking tobacco
D-shu`ch*	(∅-A) sit in cold water, bathe
-shu?kʼ*	use “cute talk” too much $ -shiˀkʼw*
she`shuˑx̱	rattle
-shu`ḵ*	(∅-A2, n-prim. -shu`ḵ) laugh, smile # ł-shu`g̱u (g-I) be funny
shu`x̱ʼ	robin, cf. sheˀx̱ʼw
shuḵʼ	$ shaḵʼw legendary wolf-like animal
shkʼe(`)	why don’t you…, shkʼa;y (< shkʼe + ha`hiˑ), shkʼa`nde (< shkʼe + ha`n-de) give it here (perhaps < tleˑł i`shkʼe ‘you are bad (if you don’t–)’ or tleˑł age ushkʼe ‘is it bad (to–)?’ $ kʼeˑ)
